sat_id,person_id,transition_id,sat_before,sat_after,sat_delta,notes
1,1,3,6,7,1,Slight improvement in work-life balance and satisfaction.
2,2,4,3,3,0,Change made little difference in overall happiness.
3,3,7,10,10,0,Change made little difference in overall happiness.
4,4,8,8,6,-2,Struggles with job satisfaction after the transition.
5,5,13,9,10,1,Slight improvement in work-life balance and satisfaction.
6,6,14,1,1,0,Change made little difference in overall happiness.
7,7,15,5,3,-2,Struggles with job satisfaction after the transition.
8,8,17,9,10,1,Slight improvement in work-life balance and satisfaction.
9,9,20,10,10,0,Change made little difference in overall happiness.
10,10,21,8,7,-1,Feels unsure about the new role and its demands.
11,11,24,2,5,3,Feels more fulfilled and motivated after switching.
12,12,25,4,2,-2,Struggles with job satisfaction after the transition.
13,13,28,9,10,1,Slight improvement in work-life balance and satisfaction.
14,14,29,8,8,0,Change made little difference in overall happiness.
15,15,32,5,8,3,Feels more fulfilled and motivated after switching.
16,16,36,7,8,1,Slight improvement in work-life balance and satisfaction.
17,17,37,9,9,0,Change made little difference in overall happiness.
18,18,39,4,3,-1,Feels unsure about the new role and its demands.
19,19,41,9,10,1,Slight improvement in work-life balance and satisfaction.
20,20,43,5,6,1,Slight improvement in work-life balance and satisfaction.
21,21,45,7,7,0,Change made little difference in overall happiness.
22,22,49,5,4,-1,Feels unsure about the new role and its demands.
23,23,50,5,5,0,Change made little difference in overall happiness.
24,24,55,10,10,0,Change made little difference in overall happiness.
25,25,57,7,5,-2,Struggles with job satisfaction after the transition.
26,26,59,3,5,2,Feels more fulfilled and motivated after switching.
27,27,60,7,5,-2,Struggles with job satisfaction after the transition.
28,28,64,1,2,1,Slight improvement in work-life balance and satisfaction.
29,29,67,5,7,2,Feels more fulfilled and motivated after switching.
30,30,69,10,10,0,Change made little difference in overall happiness.
31,31,71,6,6,0,Change made little difference in overall happiness.
32,32,72,5,5,0,Change made little difference in overall happiness.
33,33,76,1,1,0,Change made little difference in overall happiness.
34,34,77,7,7,0,Change made little difference in overall happiness.
35,35,78,5,7,2,Feels more fulfilled and motivated after switching.
36,36,81,2,2,0,Change made little difference in overall happiness.
37,37,82,4,6,2,Feels more fulfilled and motivated after switching.
38,38,83,9,7,-2,Struggles with job satisfaction after the transition.
39,39,84,4,7,3,Feels more fulfilled and motivated after switching.
40,40,87,9,10,1,Slight improvement in work-life balance and satisfaction.
41,41,89,2,1,-1,Feels unsure about the new role and its demands.
42,42,91,1,2,1,Slight improvement in work-life balance and satisfaction.
43,43,92,8,9,1,Slight improvement in work-life balance and satisfaction.
44,44,94,8,10,2,Feels more fulfilled and motivated after switching.
45,45,95,9,10,1,Slight improvement in work-life balance and satisfaction.
46,46,96,4,6,2,Feels more fulfilled and motivated after switching.
47,47,99,4,6,2,Feels more fulfilled and motivated after switching.
48,48,100,2,4,2,Feels more fulfilled and motivated after switching.
49,49,101,10,8,-2,Struggles with job satisfaction after the transition.
50,50,102,7,10,3,Feels more fulfilled and motivated after switching.
51,51,106,6,5,-1,Feels unsure about the new role and its demands.
52,52,108,10,10,0,Change made little difference in overall happiness.
53,53,109,10,10,0,Change made little difference in overall happiness.
54,54,112,9,10,1,Slight improvement in work-life balance and satisfaction.
55,55,116,5,8,3,Feels more fulfilled and motivated after switching.
56,56,117,1,3,2,Feels more fulfilled and motivated after switching.
57,57,120,6,5,-1,Feels unsure about the new role and its demands.
58,58,124,2,5,3,Feels more fulfilled and motivated after switching.
59,59,125,4,6,2,Feels more fulfilled and motivated after switching.
60,60,128,3,5,2,Feels more fulfilled and motivated after switching.
61,61,129,4,5,1,Slight improvement in work-life balance and satisfaction.
62,62,130,10,10,0,Change made little difference in overall happiness.
63,63,131,2,2,0,Change made little difference in overall happiness.
64,64,132,10,8,-2,Struggles with job satisfaction after the transition.
65,65,133,7,5,-2,Struggles with job satisfaction after the transition.
66,66,134,2,2,0,Change made little difference in overall happiness.
67,67,135,5,8,3,Feels more fulfilled and motivated after switching.
68,68,140,8,9,1,Slight improvement in work-life balance and satisfaction.
69,69,141,2,2,0,Change made little difference in overall happiness.
70,70,142,8,10,2,Feels more fulfilled and motivated after switching.
71,71,144,5,5,0,Change made little difference in overall happiness.
72,72,147,5,3,-2,Struggles with job satisfaction after the transition.
73,73,148,6,8,2,Feels more fulfilled and motivated after switching.
74,74,150,9,10,1,Slight improvement in work-life balance and satisfaction.
75,75,153,10,8,-2,Struggles with job satisfaction after the transition.
76,76,155,6,6,0,Change made little difference in overall happiness.
77,77,158,6,4,-2,Struggles with job satisfaction after the transition.
78,78,160,6,9,3,Feels more fulfilled and motivated after switching.
79,79,162,6,9,3,Feels more fulfilled and motivated after switching.
80,80,165,7,7,0,Change made little difference in overall happiness.
81,81,167,10,10,0,Change made little difference in overall happiness.
82,82,169,4,6,2,Feels more fulfilled and motivated after switching.
83,83,172,8,9,1,Slight improvement in work-life balance and satisfaction.
84,84,173,7,5,-2,Struggles with job satisfaction after the transition.
85,85,177,9,8,-1,Feels unsure about the new role and its demands.
86,86,178,9,8,-1,Feels unsure about the new role and its demands.
87,87,183,10,10,0,Change made little difference in overall happiness.
88,88,185,10,8,-2,Struggles with job satisfaction after the transition.
89,89,186,3,6,3,Feels more fulfilled and motivated after switching.
90,90,188,5,7,2,Feels more fulfilled and motivated after switching.
91,91,191,9,10,1,Slight improvement in work-life balance and satisfaction.
92,92,192,3,2,-1,Feels unsure about the new role and its demands.
93,93,194,9,8,-1,Feels unsure about the new role and its demands.
94,94,198,4,4,0,Change made little difference in overall happiness.
95,95,201,5,3,-2,Struggles with job satisfaction after the transition.
96,96,203,5,4,-1,Feels unsure about the new role and its demands.
97,97,204,2,3,1,Slight improvement in work-life balance and satisfaction.
98,98,206,8,7,-1,Feels unsure about the new role and its demands.
99,99,210,10,10,0,Change made little difference in overall happiness.
100,100,211,1,1,0,Change made little difference in overall happiness.
101,101,213,10,10,0,Change made little difference in overall happiness.
102,102,214,1,1,0,Change made little difference in overall happiness.
103,103,216,6,9,3,Feels more fulfilled and motivated after switching.
104,104,217,5,8,3,Feels more fulfilled and motivated after switching.
105,105,218,5,7,2,Feels more fulfilled and motivated after switching.
106,106,221,4,6,2,Feels more fulfilled and motivated after switching.
107,107,222,9,10,1,Slight improvement in work-life balance and satisfaction.
108,108,226,4,3,-1,Feels unsure about the new role and its demands.
109,109,228,2,1,-1,Feels unsure about the new role and its demands.
110,110,230,7,8,1,Slight improvement in work-life balance and satisfaction.
111,111,232,4,2,-2,Struggles with job satisfaction after the transition.
112,112,233,4,7,3,Feels more fulfilled and motivated after switching.
113,113,235,2,3,1,Slight improvement in work-life balance and satisfaction.
114,114,239,7,9,2,Feels more fulfilled and motivated after switching.
115,115,242,9,8,-1,Feels unsure about the new role and its demands.
116,116,243,8,10,2,Feels more fulfilled and motivated after switching.
117,117,244,6,5,-1,Feels unsure about the new role and its demands.
118,118,246,1,3,2,Feels more fulfilled and motivated after switching.
119,119,248,9,7,-2,Struggles with job satisfaction after the transition.
120,120,249,2,3,1,Slight improvement in work-life balance and satisfaction.
121,121,251,1,1,0,Change made little difference in overall happiness.
122,122,253,7,6,-1,Feels unsure about the new role and its demands.
123,123,256,4,5,1,Slight improvement in work-life balance and satisfaction.
124,124,258,2,1,-1,Feels unsure about the new role and its demands.
125,125,259,7,10,3,Feels more fulfilled and motivated after switching.
126,126,260,2,5,3,Feels more fulfilled and motivated after switching.
127,127,263,4,5,1,Slight improvement in work-life balance and satisfaction.
128,128,264,3,4,1,Slight improvement in work-life balance and satisfaction.
129,129,267,3,3,0,Change made little difference in overall happiness.
130,130,268,4,2,-2,Struggles with job satisfaction after the transition.
131,131,270,1,3,2,Feels more fulfilled and motivated after switching.
132,132,271,3,1,-2,Struggles with job satisfaction after the transition.
133,133,274,5,4,-1,Feels unsure about the new role and its demands.
134,134,275,3,1,-2,Struggles with job satisfaction after the transition.
135,135,276,1,4,3,Feels more fulfilled and motivated after switching.
136,136,279,9,10,1,Slight improvement in work-life balance and satisfaction.
137,137,281,5,8,3,Feels more fulfilled and motivated after switching.
138,138,282,2,2,0,Change made little difference in overall happiness.
139,139,284,1,2,1,Slight improvement in work-life balance and satisfaction.
140,140,285,3,4,1,Slight improvement in work-life balance and satisfaction.
141,141,288,5,3,-2,Struggles with job satisfaction after the transition.
142,142,289,9,8,-1,Feels unsure about the new role and its demands.
143,143,292,1,4,3,Feels more fulfilled and motivated after switching.
144,144,293,2,2,0,Change made little difference in overall happiness.
145,145,295,3,5,2,Feels more fulfilled and motivated after switching.
146,146,297,9,9,0,Change made little difference in overall happiness.
147,147,298,6,7,1,Slight improvement in work-life balance and satisfaction.
148,148,299,8,9,1,Slight improvement in work-life balance and satisfaction.
149,149,302,1,2,1,Slight improvement in work-life balance and satisfaction.
150,150,303,7,5,-2,Struggles with job satisfaction after the transition.
151,151,305,1,1,0,Change made little difference in overall happiness.
152,152,306,4,5,1,Slight improvement in work-life balance and satisfaction.
153,153,310,8,8,0,Change made little difference in overall happiness.
154,154,312,2,2,0,Change made little difference in overall happiness.
155,155,316,9,10,1,Slight improvement in work-life balance and satisfaction.
156,156,317,8,10,2,Feels more fulfilled and motivated after switching.
157,157,320,1,1,0,Change made little difference in overall happiness.
158,158,322,10,10,0,Change made little difference in overall happiness.
159,159,324,7,8,1,Slight improvement in work-life balance and satisfaction.
160,160,325,7,9,2,Feels more fulfilled and motivated after switching.
161,161,327,10,10,0,Change made little difference in overall happiness.
162,162,328,9,8,-1,Feels unsure about the new role and its demands.
163,163,329,4,7,3,Feels more fulfilled and motivated after switching.
164,164,330,5,3,-2,Struggles with job satisfaction after the transition.
165,165,332,9,7,-2,Struggles with job satisfaction after the transition.
166,166,335,3,4,1,Slight improvement in work-life balance and satisfaction.
167,167,337,4,3,-1,Feels unsure about the new role and its demands.
168,168,338,8,10,2,Feels more fulfilled and motivated after switching.
169,169,340,2,3,1,Slight improvement in work-life balance and satisfaction.
170,170,341,1,1,0,Change made little difference in overall happiness.
171,171,345,4,4,0,Change made little difference in overall happiness.
172,172,346,5,3,-2,Struggles with job satisfaction after the transition.
173,173,349,4,3,-1,Feels unsure about the new role and its demands.
174,174,351,4,6,2,Feels more fulfilled and motivated after switching.
175,175,352,3,6,3,Feels more fulfilled and motivated after switching.
176,176,353,6,7,1,Slight improvement in work-life balance and satisfaction.
177,177,354,2,4,2,Feels more fulfilled and motivated after switching.
178,178,358,4,6,2,Feels more fulfilled and motivated after switching.
179,179,359,9,10,1,Slight improvement in work-life balance and satisfaction.
180,180,361,7,10,3,Feels more fulfilled and motivated after switching.
181,181,363,8,6,-2,Struggles with job satisfaction after the transition.
182,182,365,5,4,-1,Feels unsure about the new role and its demands.
183,183,368,10,8,-2,Struggles with job satisfaction after the transition.
184,184,370,2,4,2,Feels more fulfilled and motivated after switching.
185,185,372,5,8,3,Feels more fulfilled and motivated after switching.
186,186,373,4,3,-1,Feels unsure about the new role and its demands.
187,187,374,3,3,0,Change made little difference in overall happiness.
188,188,376,5,4,-1,Feels unsure about the new role and its demands.
189,189,377,3,3,0,Change made little difference in overall happiness.
190,190,378,5,8,3,Feels more fulfilled and motivated after switching.
191,191,380,3,5,2,Feels more fulfilled and motivated after switching.
192,192,382,9,9,0,Change made little difference in overall happiness.
193,193,385,10,10,0,Change made little difference in overall happiness.
194,194,386,3,3,0,Change made little difference in overall happiness.
195,195,390,6,8,2,Feels more fulfilled and motivated after switching.
196,196,391,3,1,-2,Struggles with job satisfaction after the transition.
197,197,394,2,4,2,Feels more fulfilled and motivated after switching.
198,198,397,3,6,3,Feels more fulfilled and motivated after switching.
199,199,398,10,10,0,Change made little difference in overall happiness.
200,200,401,5,7,2,Feels more fulfilled and motivated after switching.
201,201,402,4,2,-2,Struggles with job satisfaction after the transition.
202,202,406,6,8,2,Feels more fulfilled and motivated after switching.
203,203,407,8,10,2,Feels more fulfilled and motivated after switching.
204,204,410,9,8,-1,Feels unsure about the new role and its demands.
205,205,411,8,8,0,Change made little difference in overall happiness.
206,206,414,7,9,2,Feels more fulfilled and motivated after switching.
207,207,415,9,10,1,Slight improvement in work-life balance and satisfaction.
208,208,418,5,5,0,Change made little difference in overall happiness.
209,209,423,8,9,1,Slight improvement in work-life balance and satisfaction.
210,210,425,1,1,0,Change made little difference in overall happiness.
211,211,428,6,5,-1,Feels unsure about the new role and its demands.
212,212,430,2,2,0,Change made little difference in overall happiness.
213,213,431,4,4,0,Change made little difference in overall happiness.
214,214,433,9,9,0,Change made little difference in overall happiness.
215,215,434,8,10,2,Feels more fulfilled and motivated after switching.
216,216,438,7,5,-2,Struggles with job satisfaction after the transition.
217,217,440,8,6,-2,Struggles with job satisfaction after the transition.
218,218,443,8,7,-1,Feels unsure about the new role and its demands.
219,219,445,10,8,-2,Struggles with job satisfaction after the transition.
220,220,447,7,9,2,Feels more fulfilled and motivated after switching.
221,221,449,9,10,1,Slight improvement in work-life balance and satisfaction.
222,222,452,5,4,-1,Feels unsure about the new role and its demands.
223,223,453,8,6,-2,Struggles with job satisfaction after the transition.
224,224,455,7,8,1,Slight improvement in work-life balance and satisfaction.
225,225,457,5,8,3,Feels more fulfilled and motivated after switching.
226,226,458,4,2,-2,Struggles with job satisfaction after the transition.
227,227,459,6,6,0,Change made little difference in overall happiness.
228,228,463,7,9,2,Feels more fulfilled and motivated after switching.
229,229,465,7,5,-2,Struggles with job satisfaction after the transition.
230,230,467,1,3,2,Feels more fulfilled and motivated after switching.
231,231,468,8,10,2,Feels more fulfilled and motivated after switching.
232,232,471,3,5,2,Feels more fulfilled and motivated after switching.
233,233,472,1,1,0,Change made little difference in overall happiness.
234,234,475,4,6,2,Feels more fulfilled and motivated after switching.
235,235,480,3,6,3,Feels more fulfilled and motivated after switching.
236,236,482,2,3,1,Slight improvement in work-life balance and satisfaction.
237,237,483,7,7,0,Change made little difference in overall happiness.
238,238,484,5,5,0,Change made little difference in overall happiness.
239,239,486,10,10,0,Change made little difference in overall happiness.
240,240,487,3,2,-1,Feels unsure about the new role and its demands.
241,241,490,10,10,0,Change made little difference in overall happiness.
242,242,493,10,10,0,Change made little difference in overall happiness.
243,243,494,3,5,2,Feels more fulfilled and motivated after switching.
244,244,495,9,7,-2,Struggles with job satisfaction after the transition.
245,245,497,3,5,2,Feels more fulfilled and motivated after switching.
246,246,499,1,1,0,Change made little difference in overall happiness.
247,247,501,4,5,1,Slight improvement in work-life balance and satisfaction.
248,248,502,8,8,0,Change made little difference in overall happiness.
249,249,503,4,4,0,Change made little difference in overall happiness.
250,250,504,10,10,0,Change made little difference in overall happiness.
251,251,507,3,5,2,Feels more fulfilled and motivated after switching.
252,252,508,6,8,2,Feels more fulfilled and motivated after switching.
253,253,512,5,6,1,Slight improvement in work-life balance and satisfaction.
254,254,513,5,8,3,Feels more fulfilled and motivated after switching.
255,255,515,9,10,1,Slight improvement in work-life balance and satisfaction.
256,256,516,10,10,0,Change made little difference in overall happiness.
257,257,518,1,2,1,Slight improvement in work-life balance and satisfaction.
258,258,519,7,10,3,Feels more fulfilled and motivated after switching.
259,259,522,3,6,3,Feels more fulfilled and motivated after switching.
260,260,524,2,5,3,Feels more fulfilled and motivated after switching.
261,261,527,7,5,-2,Struggles with job satisfaction after the transition.
262,262,530,2,1,-1,Feels unsure about the new role and its demands.
263,263,531,9,8,-1,Feels unsure about the new role and its demands.
264,264,533,5,6,1,Slight improvement in work-life balance and satisfaction.
265,265,535,2,1,-1,Feels unsure about the new role and its demands.
266,266,536,10,10,0,Change made little difference in overall happiness.
267,267,538,8,7,-1,Feels unsure about the new role and its demands.
268,268,539,2,2,0,Change made little difference in overall happiness.
269,269,541,3,3,0,Change made little difference in overall happiness.
270,270,542,10,10,0,Change made little difference in overall happiness.
271,271,545,1,2,1,Slight improvement in work-life balance and satisfaction.
272,272,548,3,5,2,Feels more fulfilled and motivated after switching.
273,273,550,6,9,3,Feels more fulfilled and motivated after switching.
274,274,555,1,2,1,Slight improvement in work-life balance and satisfaction.
275,275,556,9,10,1,Slight improvement in work-life balance and satisfaction.
276,276,557,3,1,-2,Struggles with job satisfaction after the transition.
277,277,558,9,8,-1,Feels unsure about the new role and its demands.
278,278,559,10,10,0,Change made little difference in overall happiness.
279,279,563,6,7,1,Slight improvement in work-life balance and satisfaction.
280,280,564,3,3,0,Change made little difference in overall happiness.
281,281,567,6,9,3,Feels more fulfilled and motivated after switching.
282,282,570,2,4,2,Feels more fulfilled and motivated after switching.
283,283,572,1,4,3,Feels more fulfilled and motivated after switching.
284,284,574,1,1,0,Change made little difference in overall happiness.
285,285,575,9,10,1,Slight improvement in work-life balance and satisfaction.
286,286,576,6,4,-2,Struggles with job satisfaction after the transition.
287,287,577,5,3,-2,Struggles with job satisfaction after the transition.
288,288,580,5,8,3,Feels more fulfilled and motivated after switching.
289,289,581,4,3,-1,Feels unsure about the new role and its demands.
290,290,583,2,4,2,Feels more fulfilled and motivated after switching.
291,291,585,1,1,0,Change made little difference in overall happiness.
292,292,587,3,1,-2,Struggles with job satisfaction after the transition.
293,293,588,6,9,3,Feels more fulfilled and motivated after switching.
294,294,590,7,5,-2,Struggles with job satisfaction after the transition.
295,295,591,7,8,1,Slight improvement in work-life balance and satisfaction.
296,296,592,4,5,1,Slight improvement in work-life balance and satisfaction.
297,297,594,1,1,0,Change made little difference in overall happiness.
298,298,596,3,6,3,Feels more fulfilled and motivated after switching.
299,299,598,1,1,0,Change made little difference in overall happiness.
300,300,601,10,10,0,Change made little difference in overall happiness.
301,301,604,10,10,0,Change made little difference in overall happiness.
302,302,606,9,9,0,Change made little difference in overall happiness.
303,303,607,6,6,0,Change made little difference in overall happiness.
304,304,610,7,9,2,Feels more fulfilled and motivated after switching.
305,305,613,8,7,-1,Feels unsure about the new role and its demands.
306,306,614,6,7,1,Slight improvement in work-life balance and satisfaction.
307,307,616,6,8,2,Feels more fulfilled and motivated after switching.
308,308,617,7,8,1,Slight improvement in work-life balance and satisfaction.
309,309,619,2,1,-1,Feels unsure about the new role and its demands.
310,310,621,1,3,2,Feels more fulfilled and motivated after switching.
311,311,623,1,3,2,Feels more fulfilled and motivated after switching.
312,312,625,5,3,-2,Struggles with job satisfaction after the transition.
313,313,626,1,1,0,Change made little difference in overall happiness.
314,314,627,10,8,-2,Struggles with job satisfaction after the transition.
315,315,628,3,1,-2,Struggles with job satisfaction after the transition.
316,316,631,6,8,2,Feels more fulfilled and motivated after switching.
317,317,633,10,10,0,Change made little difference in overall happiness.
318,318,635,7,6,-1,Feels unsure about the new role and its demands.
319,319,638,8,8,0,Change made little difference in overall happiness.
320,320,641,3,6,3,Feels more fulfilled and motivated after switching.
321,321,642,6,6,0,Change made little difference in overall happiness.
322,322,644,3,6,3,Feels more fulfilled and motivated after switching.
323,323,645,8,10,2,Feels more fulfilled and motivated after switching.
324,324,647,7,6,-1,Feels unsure about the new role and its demands.
325,325,649,10,10,0,Change made little difference in overall happiness.
326,326,650,10,10,0,Change made little difference in overall happiness.
327,327,651,3,5,2,Feels more fulfilled and motivated after switching.
328,328,655,5,3,-2,Struggles with job satisfaction after the transition.
329,329,656,9,8,-1,Feels unsure about the new role and its demands.
330,330,657,5,6,1,Slight improvement in work-life balance and satisfaction.
331,331,659,5,8,3,Feels more fulfilled and motivated after switching.
332,332,662,8,10,2,Feels more fulfilled and motivated after switching.
333,333,665,6,4,-2,Struggles with job satisfaction after the transition.
334,334,666,1,4,3,Feels more fulfilled and motivated after switching.
335,335,667,4,3,-1,Feels unsure about the new role and its demands.
336,336,671,10,10,0,Change made little difference in overall happiness.
337,337,674,2,1,-1,Feels unsure about the new role and its demands.
338,338,675,3,2,-1,Feels unsure about the new role and its demands.
339,339,677,2,3,1,Slight improvement in work-life balance and satisfaction.
340,340,678,2,3,1,Slight improvement in work-life balance and satisfaction.
341,341,680,7,10,3,Feels more fulfilled and motivated after switching.
342,342,683,7,5,-2,Struggles with job satisfaction after the transition.
343,343,686,1,1,0,Change made little difference in overall happiness.
344,344,688,2,2,0,Change made little difference in overall happiness.
345,345,690,4,7,3,Feels more fulfilled and motivated after switching.
346,346,693,7,6,-1,Feels unsure about the new role and its demands.
347,347,695,7,9,2,Feels more fulfilled and motivated after switching.
348,348,696,8,10,2,Feels more fulfilled and motivated after switching.
349,349,697,10,10,0,Change made little difference in overall happiness.
350,350,698,9,10,1,Slight improvement in work-life balance and satisfaction.
351,351,701,7,7,0,Change made little difference in overall happiness.
352,352,703,6,9,3,Feels more fulfilled and motivated after switching.
353,353,706,9,7,-2,Struggles with job satisfaction after the transition.
354,354,707,7,5,-2,Struggles with job satisfaction after the transition.
355,355,710,10,10,0,Change made little difference in overall happiness.
356,356,711,4,6,2,Feels more fulfilled and motivated after switching.
357,357,712,7,10,3,Feels more fulfilled and motivated after switching.
358,358,714,6,8,2,Feels more fulfilled and motivated after switching.
359,359,715,7,5,-2,Struggles with job satisfaction after the transition.
360,360,717,6,5,-1,Feels unsure about the new role and its demands.
361,361,719,7,5,-2,Struggles with job satisfaction after the transition.
362,362,723,7,10,3,Feels more fulfilled and motivated after switching.
363,363,724,3,6,3,Feels more fulfilled and motivated after switching.
364,364,728,1,1,0,Change made little difference in overall happiness.
365,365,730,9,9,0,Change made little difference in overall happiness.
366,366,731,10,8,-2,Struggles with job satisfaction after the transition.
367,367,733,3,3,0,Change made little difference in overall happiness.
368,368,735,7,6,-1,Feels unsure about the new role and its demands.
369,369,736,10,10,0,Change made little difference in overall happiness.
370,370,737,7,5,-2,Struggles with job satisfaction after the transition.
371,371,738,10,10,0,Change made little difference in overall happiness.
372,372,740,2,4,2,Feels more fulfilled and motivated after switching.
373,373,741,4,7,3,Feels more fulfilled and motivated after switching.
374,374,744,3,2,-1,Feels unsure about the new role and its demands.
375,375,746,8,6,-2,Struggles with job satisfaction after the transition.
376,376,749,3,2,-1,Feels unsure about the new role and its demands.
377,377,750,1,1,0,Change made little difference in overall happiness.
378,378,752,9,10,1,Slight improvement in work-life balance and satisfaction.
379,379,755,1,4,3,Feels more fulfilled and motivated after switching.
380,380,757,8,10,2,Feels more fulfilled and motivated after switching.
381,381,759,10,8,-2,Struggles with job satisfaction after the transition.
382,382,761,6,4,-2,Struggles with job satisfaction after the transition.
383,383,763,3,6,3,Feels more fulfilled and motivated after switching.
384,384,764,3,3,0,Change made little difference in overall happiness.
385,385,765,5,5,0,Change made little difference in overall happiness.
386,386,768,7,7,0,Change made little difference in overall happiness.
387,387,769,10,10,0,Change made little difference in overall happiness.
388,388,770,4,5,1,Slight improvement in work-life balance and satisfaction.
389,389,771,7,9,2,Feels more fulfilled and motivated after switching.
390,390,772,1,1,0,Change made little difference in overall happiness.
391,391,774,10,10,0,Change made little difference in overall happiness.
392,392,776,2,5,3,Feels more fulfilled and motivated after switching.
393,393,779,9,10,1,Slight improvement in work-life balance and satisfaction.
394,394,780,2,3,1,Slight improvement in work-life balance and satisfaction.
395,395,782,5,4,-1,Feels unsure about the new role and its demands.
396,396,786,1,2,1,Slight improvement in work-life balance and satisfaction.
397,397,787,6,4,-2,Struggles with job satisfaction after the transition.
398,398,789,1,1,0,Change made little difference in overall happiness.
399,399,790,5,4,-1,Feels unsure about the new role and its demands.
400,400,791,2,3,1,Slight improvement in work-life balance and satisfaction.
401,401,792,2,3,1,Slight improvement in work-life balance and satisfaction.
402,402,794,6,9,3,Feels more fulfilled and motivated after switching.
403,403,795,4,3,-1,Feels unsure about the new role and its demands.
404,404,796,3,4,1,Slight improvement in work-life balance and satisfaction.
405,405,799,5,6,1,Slight improvement in work-life balance and satisfaction.
406,406,800,3,1,-2,Struggles with job satisfaction after the transition.
407,407,801,3,3,0,Change made little difference in overall happiness.
408,408,803,5,7,2,Feels more fulfilled and motivated after switching.
409,409,805,6,7,1,Slight improvement in work-life balance and satisfaction.
410,410,806,4,2,-2,Struggles with job satisfaction after the transition.
411,411,807,10,10,0,Change made little difference in overall happiness.
412,412,809,7,9,2,Feels more fulfilled and motivated after switching.
413,413,811,9,10,1,Slight improvement in work-life balance and satisfaction.
414,414,812,6,9,3,Feels more fulfilled and motivated after switching.
415,415,814,6,4,-2,Struggles with job satisfaction after the transition.
416,416,815,4,6,2,Feels more fulfilled and motivated after switching.
417,417,818,5,8,3,Feels more fulfilled and motivated after switching.
418,418,821,5,5,0,Change made little difference in overall happiness.
419,419,825,1,1,0,Change made little difference in overall happiness.
420,420,827,10,10,0,Change made little difference in overall happiness.
421,421,829,3,3,0,Change made little difference in overall happiness.
422,422,832,9,8,-1,Feels unsure about the new role and its demands.
423,423,834,4,7,3,Feels more fulfilled and motivated after switching.
424,424,835,8,10,2,Feels more fulfilled and motivated after switching.
425,425,838,1,4,3,Feels more fulfilled and motivated after switching.
426,426,839,9,7,-2,Struggles with job satisfaction after the transition.
427,427,843,1,2,1,Slight improvement in work-life balance and satisfaction.
428,428,846,1,1,0,Change made little difference in overall happiness.
429,429,847,2,5,3,Feels more fulfilled and motivated after switching.
430,430,850,8,6,-2,Struggles with job satisfaction after the transition.
431,431,851,7,10,3,Feels more fulfilled and motivated after switching.
432,432,852,10,10,0,Change made little difference in overall happiness.
433,433,856,6,4,-2,Struggles with job satisfaction after the transition.
434,434,857,5,7,2,Feels more fulfilled and motivated after switching.
435,435,859,2,5,3,Feels more fulfilled and motivated after switching.
436,436,860,6,9,3,Feels more fulfilled and motivated after switching.
437,437,863,4,4,0,Change made little difference in overall happiness.
438,438,865,7,5,-2,Struggles with job satisfaction after the transition.
439,439,866,1,1,0,Change made little difference in overall happiness.
440,440,868,10,8,-2,Struggles with job satisfaction after the transition.
441,441,869,5,8,3,Feels more fulfilled and motivated after switching.
442,442,871,8,6,-2,Struggles with job satisfaction after the transition.
443,443,872,8,8,0,Change made little difference in overall happiness.
444,444,873,10,8,-2,Struggles with job satisfaction after the transition.
445,445,874,5,4,-1,Feels unsure about the new role and its demands.
446,446,876,1,2,1,Slight improvement in work-life balance and satisfaction.
447,447,879,3,4,1,Slight improvement in work-life balance and satisfaction.
448,448,881,1,1,0,Change made little difference in overall happiness.
449,449,883,1,1,0,Change made little difference in overall happiness.
450,450,884,4,6,2,Feels more fulfilled and motivated after switching.
451,451,885,1,4,3,Feels more fulfilled and motivated after switching.
452,452,887,2,1,-1,Feels unsure about the new role and its demands.
453,453,890,5,6,1,Slight improvement in work-life balance and satisfaction.
454,454,891,4,6,2,Feels more fulfilled and motivated after switching.
455,455,894,9,8,-1,Feels unsure about the new role and its demands.
456,456,895,2,5,3,Feels more fulfilled and motivated after switching.
457,457,898,6,6,0,Change made little difference in overall happiness.
458,458,899,9,10,1,Slight improvement in work-life balance and satisfaction.
459,459,902,1,2,1,Slight improvement in work-life balance and satisfaction.
460,460,904,3,4,1,Slight improvement in work-life balance and satisfaction.
461,461,905,8,8,0,Change made little difference in overall happiness.
462,462,909,10,10,0,Change made little difference in overall happiness.
463,463,911,8,6,-2,Struggles with job satisfaction after the transition.
464,464,914,3,1,-2,Struggles with job satisfaction after the transition.
465,465,916,2,3,1,Slight improvement in work-life balance and satisfaction.
466,466,918,3,5,2,Feels more fulfilled and motivated after switching.
467,467,920,6,7,1,Slight improvement in work-life balance and satisfaction.
468,468,922,5,7,2,Feels more fulfilled and motivated after switching.
469,469,923,10,8,-2,Struggles with job satisfaction after the transition.
470,470,925,8,8,0,Change made little difference in overall happiness.
471,471,927,2,1,-1,Feels unsure about the new role and its demands.
472,472,930,10,10,0,Change made little difference in overall happiness.
473,473,933,4,4,0,Change made little difference in overall happiness.
474,474,936,2,1,-1,Feels unsure about the new role and its demands.
475,475,938,4,2,-2,Struggles with job satisfaction after the transition.
476,476,940,6,5,-1,Feels unsure about the new role and its demands.
477,477,942,5,4,-1,Feels unsure about the new role and its demands.
478,478,943,9,8,-1,Feels unsure about the new role and its demands.
479,479,944,9,7,-2,Struggles with job satisfaction after the transition.
480,480,945,10,8,-2,Struggles with job satisfaction after the transition.
481,481,947,10,9,-1,Feels unsure about the new role and its demands.
482,482,949,4,6,2,Feels more fulfilled and motivated after switching.
483,483,950,8,10,2,Feels more fulfilled and motivated after switching.
484,484,953,8,6,-2,Struggles with job satisfaction after the transition.
485,485,955,10,8,-2,Struggles with job satisfaction after the transition.
486,486,958,10,10,0,Change made little difference in overall happiness.
487,487,959,7,6,-1,Feels unsure about the new role and its demands.
488,488,962,2,4,2,Feels more fulfilled and motivated after switching.
489,489,966,9,10,1,Slight improvement in work-life balance and satisfaction.
490,490,967,8,10,2,Feels more fulfilled and motivated after switching.
491,491,970,8,10,2,Feels more fulfilled and motivated after switching.
492,492,972,5,6,1,Slight improvement in work-life balance and satisfaction.
493,493,975,1,1,0,Change made little difference in overall happiness.
494,494,977,2,1,-1,Feels unsure about the new role and its demands.
495,495,978,6,8,2,Feels more fulfilled and motivated after switching.
496,496,980,1,1,0,Change made little difference in overall happiness.
497,497,982,8,10,2,Feels more fulfilled and motivated after switching.
498,498,985,4,3,-1,Feels unsure about the new role and its demands.
499,499,986,10,9,-1,Feels unsure about the new role and its demands.
500,500,987,3,1,-2,Struggles with job satisfaction after the transition.
501,501,990,2,1,-1,Feels unsure about the new role and its demands.
502,502,992,5,6,1,Slight improvement in work-life balance and satisfaction.
503,503,993,2,2,0,Change made little difference in overall happiness.
504,504,996,9,8,-1,Feels unsure about the new role and its demands.
505,505,997,5,5,0,Change made little difference in overall happiness.
506,506,999,10,8,-2,Struggles with job satisfaction after the transition.
507,507,1002,9,10,1,Slight improvement in work-life balance and satisfaction.
508,508,1003,4,6,2,Feels more fulfilled and motivated after switching.
509,509,1006,3,5,2,Feels more fulfilled and motivated after switching.
510,510,1007,8,10,2,Feels more fulfilled and motivated after switching.
511,511,1008,6,8,2,Feels more fulfilled and motivated after switching.
512,512,1009,1,1,0,Change made little difference in overall happiness.
513,513,1011,7,7,0,Change made little difference in overall happiness.
514,514,1012,1,3,2,Feels more fulfilled and motivated after switching.
515,515,1015,10,10,0,Change made little difference in overall happiness.
516,516,1017,6,8,2,Feels more fulfilled and motivated after switching.
517,517,1019,3,3,0,Change made little difference in overall happiness.
518,518,1020,4,2,-2,Struggles with job satisfaction after the transition.
519,519,1021,7,6,-1,Feels unsure about the new role and its demands.
520,520,1023,2,5,3,Feels more fulfilled and motivated after switching.
521,521,1025,4,4,0,Change made little difference in overall happiness.
522,522,1026,2,4,2,Feels more fulfilled and motivated after switching.
523,523,1028,9,9,0,Change made little difference in overall happiness.
524,524,1029,9,10,1,Slight improvement in work-life balance and satisfaction.
525,525,1030,2,1,-1,Feels unsure about the new role and its demands.
526,526,1032,1,1,0,Change made little difference in overall happiness.
527,527,1033,7,7,0,Change made little difference in overall happiness.
528,528,1036,8,8,0,Change made little difference in overall happiness.
529,529,1038,7,5,-2,Struggles with job satisfaction after the transition.
530,530,1039,1,2,1,Slight improvement in work-life balance and satisfaction.
531,531,1042,2,1,-1,Feels unsure about the new role and its demands.
532,532,1043,5,3,-2,Struggles with job satisfaction after the transition.
533,533,1044,7,10,3,Feels more fulfilled and motivated after switching.
534,534,1045,2,4,2,Feels more fulfilled and motivated after switching.
535,535,1047,5,3,-2,Struggles with job satisfaction after the transition.
536,536,1049,8,10,2,Feels more fulfilled and motivated after switching.
537,537,1051,2,3,1,Slight improvement in work-life balance and satisfaction.
538,538,1053,2,5,3,Feels more fulfilled and motivated after switching.
539,539,1054,4,6,2,Feels more fulfilled and motivated after switching.
540,540,1055,2,1,-1,Feels unsure about the new role and its demands.
541,541,1057,5,3,-2,Struggles with job satisfaction after the transition.
542,542,1059,3,4,1,Slight improvement in work-life balance and satisfaction.
543,543,1060,3,6,3,Feels more fulfilled and motivated after switching.
544,544,1061,6,5,-1,Feels unsure about the new role and its demands.
545,545,1062,7,10,3,Feels more fulfilled and motivated after switching.
546,546,1064,9,8,-1,Feels unsure about the new role and its demands.
547,547,1066,9,9,0,Change made little difference in overall happiness.
548,548,1067,1,1,0,Change made little difference in overall happiness.
549,549,1069,5,4,-1,Feels unsure about the new role and its demands.
550,550,1070,6,9,3,Feels more fulfilled and motivated after switching.
551,551,1072,5,8,3,Feels more fulfilled and motivated after switching.
552,552,1073,9,10,1,Slight improvement in work-life balance and satisfaction.
553,553,1074,1,1,0,Change made little difference in overall happiness.
554,554,1075,9,10,1,Slight improvement in work-life balance and satisfaction.
555,555,1077,8,6,-2,Struggles with job satisfaction after the transition.
556,556,1078,7,6,-1,Feels unsure about the new role and its demands.
557,557,1080,6,4,-2,Struggles with job satisfaction after the transition.
558,558,1081,2,3,1,Slight improvement in work-life balance and satisfaction.
559,559,1083,2,5,3,Feels more fulfilled and motivated after switching.
560,560,1085,6,4,-2,Struggles with job satisfaction after the transition.
561,561,1086,7,10,3,Feels more fulfilled and motivated after switching.
562,562,1090,4,6,2,Feels more fulfilled and motivated after switching.
563,563,1092,2,4,2,Feels more fulfilled and motivated after switching.
564,564,1093,10,8,-2,Struggles with job satisfaction after the transition.
565,565,1096,10,8,-2,Struggles with job satisfaction after the transition.
566,566,1097,2,1,-1,Feels unsure about the new role and its demands.
567,567,1099,8,10,2,Feels more fulfilled and motivated after switching.
568,568,1102,5,6,1,Slight improvement in work-life balance and satisfaction.
569,569,1103,9,10,1,Slight improvement in work-life balance and satisfaction.
570,570,1106,8,9,1,Slight improvement in work-life balance and satisfaction.
571,571,1107,1,1,0,Change made little difference in overall happiness.
572,572,1110,9,9,0,Change made little difference in overall happiness.
573,573,1114,1,2,1,Slight improvement in work-life balance and satisfaction.
574,574,1116,9,10,1,Slight improvement in work-life balance and satisfaction.
575,575,1117,6,4,-2,Struggles with job satisfaction after the transition.
576,576,1118,10,8,-2,Struggles with job satisfaction after the transition.
577,577,1120,4,4,0,Change made little difference in overall happiness.
578,578,1122,5,8,3,Feels more fulfilled and motivated after switching.
579,579,1124,6,5,-1,Feels unsure about the new role and its demands.
580,580,1125,2,3,1,Slight improvement in work-life balance and satisfaction.
581,581,1126,9,7,-2,Struggles with job satisfaction after the transition.
582,582,1129,6,6,0,Change made little difference in overall happiness.
583,583,1131,7,5,-2,Struggles with job satisfaction after the transition.
584,584,1132,4,2,-2,Struggles with job satisfaction after the transition.
585,585,1134,3,6,3,Feels more fulfilled and motivated after switching.
586,586,1135,8,8,0,Change made little difference in overall happiness.
587,587,1137,3,3,0,Change made little difference in overall happiness.
588,588,1138,9,8,-1,Feels unsure about the new role and its demands.
589,589,1140,3,6,3,Feels more fulfilled and motivated after switching.
590,590,1141,4,7,3,Feels more fulfilled and motivated after switching.
591,591,1143,2,3,1,Slight improvement in work-life balance and satisfaction.
592,592,1144,3,5,2,Feels more fulfilled and motivated after switching.
593,593,1145,10,10,0,Change made little difference in overall happiness.
594,594,1148,5,7,2,Feels more fulfilled and motivated after switching.
595,595,1150,1,2,1,Slight improvement in work-life balance and satisfaction.
596,596,1155,10,10,0,Change made little difference in overall happiness.
597,597,1157,2,1,-1,Feels unsure about the new role and its demands.
598,598,1160,9,7,-2,Struggles with job satisfaction after the transition.
599,599,1162,7,7,0,Change made little difference in overall happiness.
600,600,1165,1,3,2,Feels more fulfilled and motivated after switching.
601,601,1168,1,1,0,Change made little difference in overall happiness.
602,602,1170,8,10,2,Feels more fulfilled and motivated after switching.
603,603,1172,4,5,1,Slight improvement in work-life balance and satisfaction.
604,604,1174,1,1,0,Change made little difference in overall happiness.
605,605,1175,8,10,2,Feels more fulfilled and motivated after switching.
606,606,1176,8,9,1,Slight improvement in work-life balance and satisfaction.
607,607,1178,4,3,-1,Feels unsure about the new role and its demands.
608,608,1181,2,1,-1,Feels unsure about the new role and its demands.
609,609,1182,6,6,0,Change made little difference in overall happiness.
610,610,1183,2,1,-1,Feels unsure about the new role and its demands.
611,611,1186,7,8,1,Slight improvement in work-life balance and satisfaction.
612,612,1188,1,1,0,Change made little difference in overall happiness.
613,613,1191,4,6,2,Feels more fulfilled and motivated after switching.
614,614,1194,5,3,-2,Struggles with job satisfaction after the transition.
615,615,1196,3,6,3,Feels more fulfilled and motivated after switching.
616,616,1199,10,10,0,Change made little difference in overall happiness.
617,617,1201,1,2,1,Slight improvement in work-life balance and satisfaction.
618,618,1204,9,9,0,Change made little difference in overall happiness.
619,619,1205,6,4,-2,Struggles with job satisfaction after the transition.
620,620,1207,2,2,0,Change made little difference in overall happiness.
621,621,1208,2,1,-1,Feels unsure about the new role and its demands.
622,622,1211,7,8,1,Slight improvement in work-life balance and satisfaction.
623,623,1212,1,1,0,Change made little difference in overall happiness.
624,624,1214,2,3,1,Slight improvement in work-life balance and satisfaction.
625,625,1216,8,8,0,Change made little difference in overall happiness.
626,626,1218,3,1,-2,Struggles with job satisfaction after the transition.
627,627,1219,7,6,-1,Feels unsure about the new role and its demands.
628,628,1223,3,3,0,Change made little difference in overall happiness.
629,629,1226,5,7,2,Feels more fulfilled and motivated after switching.
630,630,1227,10,10,0,Change made little difference in overall happiness.
631,631,1230,9,7,-2,Struggles with job satisfaction after the transition.
632,632,1231,6,6,0,Change made little difference in overall happiness.
633,633,1233,7,6,-1,Feels unsure about the new role and its demands.
634,634,1234,8,6,-2,Struggles with job satisfaction after the transition.
635,635,1237,6,5,-1,Feels unsure about the new role and its demands.
636,636,1240,10,10,0,Change made little difference in overall happiness.
637,637,1241,2,1,-1,Feels unsure about the new role and its demands.
638,638,1242,3,3,0,Change made little difference in overall happiness.
639,639,1243,9,9,0,Change made little difference in overall happiness.
640,640,1245,5,3,-2,Struggles with job satisfaction after the transition.
641,641,1247,7,10,3,Feels more fulfilled and motivated after switching.
642,642,1250,2,4,2,Feels more fulfilled and motivated after switching.
643,643,1251,5,3,-2,Struggles with job satisfaction after the transition.
644,644,1253,2,1,-1,Feels unsure about the new role and its demands.
645,645,1254,4,5,1,Slight improvement in work-life balance and satisfaction.
646,646,1255,1,1,0,Change made little difference in overall happiness.
647,647,1260,7,6,-1,Feels unsure about the new role and its demands.
648,648,1261,9,10,1,Slight improvement in work-life balance and satisfaction.
649,649,1262,7,5,-2,Struggles with job satisfaction after the transition.
650,650,1264,9,8,-1,Feels unsure about the new role and its demands.
651,651,1265,9,8,-1,Feels unsure about the new role and its demands.
652,652,1268,10,8,-2,Struggles with job satisfaction after the transition.
653,653,1269,2,4,2,Feels more fulfilled and motivated after switching.
654,654,1270,2,4,2,Feels more fulfilled and motivated after switching.
655,655,1273,8,8,0,Change made little difference in overall happiness.
656,656,1275,3,2,-1,Feels unsure about the new role and its demands.
657,657,1279,6,9,3,Feels more fulfilled and motivated after switching.
658,658,1280,9,8,-1,Feels unsure about the new role and its demands.
659,659,1284,8,8,0,Change made little difference in overall happiness.
660,660,1288,6,9,3,Feels more fulfilled and motivated after switching.
661,661,1290,4,7,3,Feels more fulfilled and motivated after switching.
662,662,1291,6,7,1,Slight improvement in work-life balance and satisfaction.
663,663,1293,10,10,0,Change made little difference in overall happiness.
664,664,1295,8,10,2,Feels more fulfilled and motivated after switching.
665,665,1296,10,10,0,Change made little difference in overall happiness.
666,666,1299,4,7,3,Feels more fulfilled and motivated after switching.
667,667,1302,2,5,3,Feels more fulfilled and motivated after switching.
668,668,1304,10,8,-2,Struggles with job satisfaction after the transition.
669,669,1306,7,6,-1,Feels unsure about the new role and its demands.
670,670,1307,3,3,0,Change made little difference in overall happiness.
671,671,1310,3,2,-1,Feels unsure about the new role and its demands.
672,672,1312,3,2,-1,Feels unsure about the new role and its demands.
673,673,1313,6,9,3,Feels more fulfilled and motivated after switching.
674,674,1314,10,10,0,Change made little difference in overall happiness.
675,675,1315,1,1,0,Change made little difference in overall happiness.
676,676,1316,9,10,1,Slight improvement in work-life balance and satisfaction.
677,677,1321,6,5,-1,Feels unsure about the new role and its demands.
678,678,1324,9,8,-1,Feels unsure about the new role and its demands.
679,679,1325,10,8,-2,Struggles with job satisfaction after the transition.
680,680,1328,3,3,0,Change made little difference in overall happiness.
681,681,1329,3,1,-2,Struggles with job satisfaction after the transition.
682,682,1330,10,9,-1,Feels unsure about the new role and its demands.
683,683,1331,7,6,-1,Feels unsure about the new role and its demands.
684,684,1332,6,7,1,Slight improvement in work-life balance and satisfaction.
685,685,1334,7,10,3,Feels more fulfilled and motivated after switching.
686,686,1335,7,8,1,Slight improvement in work-life balance and satisfaction.
687,687,1338,3,1,-2,Struggles with job satisfaction after the transition.
688,688,1339,4,7,3,Feels more fulfilled and motivated after switching.
689,689,1342,7,6,-1,Feels unsure about the new role and its demands.
690,690,1347,3,5,2,Feels more fulfilled and motivated after switching.
691,691,1348,1,4,3,Feels more fulfilled and motivated after switching.
692,692,1350,5,3,-2,Struggles with job satisfaction after the transition.
693,693,1351,4,2,-2,Struggles with job satisfaction after the transition.
694,694,1355,6,8,2,Feels more fulfilled and motivated after switching.
695,695,1357,2,1,-1,Feels unsure about the new role and its demands.
696,696,1359,8,9,1,Slight improvement in work-life balance and satisfaction.
697,697,1362,6,9,3,Feels more fulfilled and motivated after switching.
698,698,1363,7,10,3,Feels more fulfilled and motivated after switching.
699,699,1364,10,10,0,Change made little difference in overall happiness.
700,700,1365,7,5,-2,Struggles with job satisfaction after the transition.
701,701,1368,5,3,-2,Struggles with job satisfaction after the transition.
702,702,1369,1,1,0,Change made little difference in overall happiness.
703,703,1372,5,8,3,Feels more fulfilled and motivated after switching.
704,704,1374,2,2,0,Change made little difference in overall happiness.
705,705,1376,1,4,3,Feels more fulfilled and motivated after switching.
706,706,1377,6,6,0,Change made little difference in overall happiness.
707,707,1378,3,1,-2,Struggles with job satisfaction after the transition.
708,708,1380,5,7,2,Feels more fulfilled and motivated after switching.
709,709,1382,3,5,2,Feels more fulfilled and motivated after switching.
710,710,1384,4,7,3,Feels more fulfilled and motivated after switching.
711,711,1387,9,8,-1,Feels unsure about the new role and its demands.
712,712,1388,10,10,0,Change made little difference in overall happiness.
713,713,1390,2,3,1,Slight improvement in work-life balance and satisfaction.
714,714,1393,9,10,1,Slight improvement in work-life balance and satisfaction.
715,715,1394,7,7,0,Change made little difference in overall happiness.
716,716,1395,5,7,2,Feels more fulfilled and motivated after switching.
717,717,1400,2,2,0,Change made little difference in overall happiness.
718,718,1401,10,9,-1,Feels unsure about the new role and its demands.
719,719,1402,2,2,0,Change made little difference in overall happiness.
720,720,1404,10,10,0,Change made little difference in overall happiness.
721,721,1406,10,10,0,Change made little difference in overall happiness.
722,722,1408,3,4,1,Slight improvement in work-life balance and satisfaction.
723,723,1410,2,2,0,Change made little difference in overall happiness.
724,724,1411,6,5,-1,Feels unsure about the new role and its demands.
725,725,1416,1,3,2,Feels more fulfilled and motivated after switching.
726,726,1417,5,8,3,Feels more fulfilled and motivated after switching.
727,727,1419,2,4,2,Feels more fulfilled and motivated after switching.
728,728,1422,8,10,2,Feels more fulfilled and motivated after switching.
729,729,1424,9,10,1,Slight improvement in work-life balance and satisfaction.
730,730,1425,3,5,2,Feels more fulfilled and motivated after switching.
731,731,1429,2,4,2,Feels more fulfilled and motivated after switching.
732,732,1430,10,10,0,Change made little difference in overall happiness.
733,733,1431,10,10,0,Change made little difference in overall happiness.
734,734,1432,6,5,-1,Feels unsure about the new role and its demands.
735,735,1436,5,3,-2,Struggles with job satisfaction after the transition.
736,736,1437,3,3,0,Change made little difference in overall happiness.
737,737,1438,3,3,0,Change made little difference in overall happiness.
738,738,1441,8,6,-2,Struggles with job satisfaction after the transition.
739,739,1442,6,9,3,Feels more fulfilled and motivated after switching.
740,740,1446,1,3,2,Feels more fulfilled and motivated after switching.
741,741,1447,1,1,0,Change made little difference in overall happiness.
742,742,1450,8,10,2,Feels more fulfilled and motivated after switching.
743,743,1454,4,6,2,Feels more fulfilled and motivated after switching.
744,744,1455,10,10,0,Change made little difference in overall happiness.
745,745,1456,3,6,3,Feels more fulfilled and motivated after switching.
746,746,1460,6,9,3,Feels more fulfilled and motivated after switching.
747,747,1461,6,4,-2,Struggles with job satisfaction after the transition.
748,748,1462,10,10,0,Change made little difference in overall happiness.
749,749,1464,8,10,2,Feels more fulfilled and motivated after switching.
750,750,1466,2,3,1,Slight improvement in work-life balance and satisfaction.
751,751,1468,6,4,-2,Struggles with job satisfaction after the transition.
752,752,1469,2,5,3,Feels more fulfilled and motivated after switching.
753,753,1472,10,10,0,Change made little difference in overall happiness.
754,754,1473,10,9,-1,Feels unsure about the new role and its demands.
755,755,1475,7,10,3,Feels more fulfilled and motivated after switching.
756,756,1479,8,10,2,Feels more fulfilled and motivated after switching.
757,757,1481,9,10,1,Slight improvement in work-life balance and satisfaction.
758,758,1482,9,7,-2,Struggles with job satisfaction after the transition.
759,759,1484,7,6,-1,Feels unsure about the new role and its demands.
760,760,1485,8,9,1,Slight improvement in work-life balance and satisfaction.
761,761,1489,5,7,2,Feels more fulfilled and motivated after switching.
762,762,1491,8,7,-1,Feels unsure about the new role and its demands.
763,763,1494,7,9,2,Feels more fulfilled and motivated after switching.
764,764,1495,4,3,-1,Feels unsure about the new role and its demands.
765,765,1496,6,8,2,Feels more fulfilled and motivated after switching.
766,766,1499,6,4,-2,Struggles with job satisfaction after the transition.
767,767,1502,1,3,2,Feels more fulfilled and motivated after switching.
768,768,1503,1,3,2,Feels more fulfilled and motivated after switching.
769,769,1505,6,5,-1,Feels unsure about the new role and its demands.
770,770,1508,8,10,2,Feels more fulfilled and motivated after switching.
771,771,1510,4,2,-2,Struggles with job satisfaction after the transition.
772,772,1512,7,9,2,Feels more fulfilled and motivated after switching.
773,773,1513,1,4,3,Feels more fulfilled and motivated after switching.
774,774,1514,2,2,0,Change made little difference in overall happiness.
775,775,1517,5,4,-1,Feels unsure about the new role and its demands.
776,776,1518,5,6,1,Slight improvement in work-life balance and satisfaction.
777,777,1519,3,5,2,Feels more fulfilled and motivated after switching.
778,778,1524,7,6,-1,Feels unsure about the new role and its demands.
779,779,1525,1,3,2,Feels more fulfilled and motivated after switching.
780,780,1529,5,7,2,Feels more fulfilled and motivated after switching.
781,781,1530,7,9,2,Feels more fulfilled and motivated after switching.
782,782,1534,8,8,0,Change made little difference in overall happiness.
783,783,1535,8,7,-1,Feels unsure about the new role and its demands.
784,784,1536,9,9,0,Change made little difference in overall happiness.
785,785,1537,1,1,0,Change made little difference in overall happiness.
786,786,1539,8,10,2,Feels more fulfilled and motivated after switching.
787,787,1542,10,10,0,Change made little difference in overall happiness.
788,788,1543,4,4,0,Change made little difference in overall happiness.
789,789,1545,2,5,3,Feels more fulfilled and motivated after switching.
790,790,1546,2,5,3,Feels more fulfilled and motivated after switching.
791,791,1550,10,10,0,Change made little difference in overall happiness.
792,792,1553,2,4,2,Feels more fulfilled and motivated after switching.
793,793,1556,8,9,1,Slight improvement in work-life balance and satisfaction.
794,794,1557,4,5,1,Slight improvement in work-life balance and satisfaction.
795,795,1560,9,8,-1,Feels unsure about the new role and its demands.
796,796,1563,8,10,2,Feels more fulfilled and motivated after switching.
797,797,1566,4,3,-1,Feels unsure about the new role and its demands.
798,798,1568,10,10,0,Change made little difference in overall happiness.
799,799,1570,7,6,-1,Feels unsure about the new role and its demands.
800,800,1572,4,7,3,Feels more fulfilled and motivated after switching.
801,801,1577,8,7,-1,Feels unsure about the new role and its demands.
802,802,1578,6,9,3,Feels more fulfilled and motivated after switching.
803,803,1579,6,7,1,Slight improvement in work-life balance and satisfaction.
804,804,1581,3,1,-2,Struggles with job satisfaction after the transition.
805,805,1583,2,1,-1,Feels unsure about the new role and its demands.
806,806,1584,10,10,0,Change made little difference in overall happiness.
807,807,1586,6,4,-2,Struggles with job satisfaction after the transition.
808,808,1587,5,5,0,Change made little difference in overall happiness.
809,809,1589,3,4,1,Slight improvement in work-life balance and satisfaction.
810,810,1590,8,8,0,Change made little difference in overall happiness.
811,811,1593,2,5,3,Feels more fulfilled and motivated after switching.
812,812,1594,4,6,2,Feels more fulfilled and motivated after switching.
813,813,1595,8,6,-2,Struggles with job satisfaction after the transition.
814,814,1597,8,10,2,Feels more fulfilled and motivated after switching.
815,815,1598,2,1,-1,Feels unsure about the new role and its demands.
816,816,1600,6,9,3,Feels more fulfilled and motivated after switching.
817,817,1601,9,7,-2,Struggles with job satisfaction after the transition.
818,818,1603,9,9,0,Change made little difference in overall happiness.
819,819,1607,4,7,3,Feels more fulfilled and motivated after switching.
820,820,1608,10,10,0,Change made little difference in overall happiness.
821,821,1610,5,4,-1,Feels unsure about the new role and its demands.
822,822,1611,7,9,2,Feels more fulfilled and motivated after switching.
823,823,1612,1,4,3,Feels more fulfilled and motivated after switching.
824,824,1613,5,7,2,Feels more fulfilled and motivated after switching.
825,825,1616,8,6,-2,Struggles with job satisfaction after the transition.
826,826,1618,7,6,-1,Feels unsure about the new role and its demands.
827,827,1619,8,10,2,Feels more fulfilled and motivated after switching.
828,828,1621,2,1,-1,Feels unsure about the new role and its demands.
829,829,1624,8,10,2,Feels more fulfilled and motivated after switching.
830,830,1625,8,10,2,Feels more fulfilled and motivated after switching.
831,831,1628,9,7,-2,Struggles with job satisfaction after the transition.
832,832,1629,6,5,-1,Feels unsure about the new role and its demands.
833,833,1631,8,8,0,Change made little difference in overall happiness.
834,834,1633,1,1,0,Change made little difference in overall happiness.
835,835,1635,1,1,0,Change made little difference in overall happiness.
836,836,1637,4,6,2,Feels more fulfilled and motivated after switching.
837,837,1639,4,7,3,Feels more fulfilled and motivated after switching.
838,838,1642,10,10,0,Change made little difference in overall happiness.
839,839,1643,6,7,1,Slight improvement in work-life balance and satisfaction.
840,840,1645,10,10,0,Change made little difference in overall happiness.
841,841,1646,3,2,-1,Feels unsure about the new role and its demands.
842,842,1651,6,8,2,Feels more fulfilled and motivated after switching.
843,843,1652,7,7,0,Change made little difference in overall happiness.
844,844,1654,1,4,3,Feels more fulfilled and motivated after switching.
845,845,1656,6,5,-1,Feels unsure about the new role and its demands.
846,846,1658,1,1,0,Change made little difference in overall happiness.
847,847,1660,5,4,-1,Feels unsure about the new role and its demands.
848,848,1662,4,2,-2,Struggles with job satisfaction after the transition.
849,849,1665,9,8,-1,Feels unsure about the new role and its demands.
850,850,1666,4,5,1,Slight improvement in work-life balance and satisfaction.
851,851,1670,8,7,-1,Feels unsure about the new role and its demands.
852,852,1672,5,4,-1,Feels unsure about the new role and its demands.
853,853,1674,8,10,2,Feels more fulfilled and motivated after switching.
854,854,1676,4,6,2,Feels more fulfilled and motivated after switching.
855,855,1677,2,4,2,Feels more fulfilled and motivated after switching.
856,856,1680,3,4,1,Slight improvement in work-life balance and satisfaction.
857,857,1681,3,3,0,Change made little difference in overall happiness.
858,858,1682,4,7,3,Feels more fulfilled and motivated after switching.
859,859,1685,3,2,-1,Feels unsure about the new role and its demands.
860,860,1688,10,10,0,Change made little difference in overall happiness.
861,861,1689,2,1,-1,Feels unsure about the new role and its demands.
862,862,1692,7,9,2,Feels more fulfilled and motivated after switching.
863,863,1695,1,2,1,Slight improvement in work-life balance and satisfaction.
864,864,1696,10,10,0,Change made little difference in overall happiness.
865,865,1700,8,8,0,Change made little difference in overall happiness.
866,866,1703,7,10,3,Feels more fulfilled and motivated after switching.
867,867,1705,10,10,0,Change made little difference in overall happiness.
868,868,1709,6,8,2,Feels more fulfilled and motivated after switching.
869,869,1710,8,10,2,Feels more fulfilled and motivated after switching.
870,870,1712,4,5,1,Slight improvement in work-life balance and satisfaction.
871,871,1714,3,1,-2,Struggles with job satisfaction after the transition.
872,872,1716,10,10,0,Change made little difference in overall happiness.
873,873,1719,1,4,3,Feels more fulfilled and motivated after switching.
874,874,1721,8,8,0,Change made little difference in overall happiness.
875,875,1722,4,6,2,Feels more fulfilled and motivated after switching.
876,876,1726,7,8,1,Slight improvement in work-life balance and satisfaction.
877,877,1728,6,5,-1,Feels unsure about the new role and its demands.
878,878,1730,7,10,3,Feels more fulfilled and motivated after switching.
879,879,1732,1,4,3,Feels more fulfilled and motivated after switching.
880,880,1736,9,10,1,Slight improvement in work-life balance and satisfaction.
881,881,1737,10,10,0,Change made little difference in overall happiness.
882,882,1739,10,8,-2,Struggles with job satisfaction after the transition.
883,883,1741,2,1,-1,Feels unsure about the new role and its demands.
884,884,1743,2,4,2,Feels more fulfilled and motivated after switching.
885,885,1745,10,10,0,Change made little difference in overall happiness.
886,886,1747,9,10,1,Slight improvement in work-life balance and satisfaction.
887,887,1749,3,6,3,Feels more fulfilled and motivated after switching.
888,888,1751,5,7,2,Feels more fulfilled and motivated after switching.
889,889,1754,3,2,-1,Feels unsure about the new role and its demands.
890,890,1755,8,7,-1,Feels unsure about the new role and its demands.
891,891,1756,7,6,-1,Feels unsure about the new role and its demands.
892,892,1759,7,5,-2,Struggles with job satisfaction after the transition.
893,893,1760,6,5,-1,Feels unsure about the new role and its demands.
894,894,1761,7,8,1,Slight improvement in work-life balance and satisfaction.
895,895,1762,1,2,1,Slight improvement in work-life balance and satisfaction.
896,896,1763,6,7,1,Slight improvement in work-life balance and satisfaction.
897,897,1764,3,4,1,Slight improvement in work-life balance and satisfaction.
898,898,1765,6,8,2,Feels more fulfilled and motivated after switching.
899,899,1766,2,1,-1,Feels unsure about the new role and its demands.
900,900,1769,3,3,0,Change made little difference in overall happiness.
901,901,1772,6,7,1,Slight improvement in work-life balance and satisfaction.
902,902,1774,1,1,0,Change made little difference in overall happiness.
903,903,1778,7,7,0,Change made little difference in overall happiness.
904,904,1779,3,6,3,Feels more fulfilled and motivated after switching.
905,905,1782,4,6,2,Feels more fulfilled and motivated after switching.
906,906,1785,3,5,2,Feels more fulfilled and motivated after switching.
907,907,1787,6,7,1,Slight improvement in work-life balance and satisfaction.
908,908,1789,6,4,-2,Struggles with job satisfaction after the transition.
909,909,1790,10,9,-1,Feels unsure about the new role and its demands.
910,910,1793,10,9,-1,Feels unsure about the new role and its demands.
911,911,1796,4,3,-1,Feels unsure about the new role and its demands.
912,912,1798,9,9,0,Change made little difference in overall happiness.
913,913,1799,3,3,0,Change made little difference in overall happiness.
914,914,1801,7,8,1,Slight improvement in work-life balance and satisfaction.
915,915,1802,1,3,2,Feels more fulfilled and motivated after switching.
916,916,1803,4,4,0,Change made little difference in overall happiness.
917,917,1807,6,5,-1,Feels unsure about the new role and its demands.
918,918,1808,2,1,-1,Feels unsure about the new role and its demands.
919,919,1809,10,10,0,Change made little difference in overall happiness.
920,920,1810,3,1,-2,Struggles with job satisfaction after the transition.
921,921,1813,2,1,-1,Feels unsure about the new role and its demands.
922,922,1815,6,6,0,Change made little difference in overall happiness.
923,923,1817,1,1,0,Change made little difference in overall happiness.
924,924,1819,9,8,-1,Feels unsure about the new role and its demands.
925,925,1821,3,5,2,Feels more fulfilled and motivated after switching.
926,926,1825,7,10,3,Feels more fulfilled and motivated after switching.
927,927,1826,3,1,-2,Struggles with job satisfaction after the transition.
928,928,1829,5,5,0,Change made little difference in overall happiness.
929,929,1830,10,10,0,Change made little difference in overall happiness.
930,930,1832,6,5,-1,Feels unsure about the new role and its demands.
931,931,1834,2,1,-1,Feels unsure about the new role and its demands.
932,932,1837,2,4,2,Feels more fulfilled and motivated after switching.
933,933,1838,3,2,-1,Feels unsure about the new role and its demands.
934,934,1842,9,7,-2,Struggles with job satisfaction after the transition.
935,935,1844,7,6,-1,Feels unsure about the new role and its demands.
936,936,1845,5,3,-2,Struggles with job satisfaction after the transition.
937,937,1847,7,6,-1,Feels unsure about the new role and its demands.
938,938,1849,10,8,-2,Struggles with job satisfaction after the transition.
939,939,1851,10,9,-1,Feels unsure about the new role and its demands.
940,940,1852,4,3,-1,Feels unsure about the new role and its demands.
941,941,1855,8,10,2,Feels more fulfilled and motivated after switching.
942,942,1856,2,4,2,Feels more fulfilled and motivated after switching.
943,943,1859,9,10,1,Slight improvement in work-life balance and satisfaction.
944,944,1862,6,8,2,Feels more fulfilled and motivated after switching.
945,945,1865,5,5,0,Change made little difference in overall happiness.
946,946,1867,3,5,2,Feels more fulfilled and motivated after switching.
947,947,1868,4,6,2,Feels more fulfilled and motivated after switching.
948,948,1872,9,10,1,Slight improvement in work-life balance and satisfaction.
949,949,1873,4,6,2,Feels more fulfilled and motivated after switching.
950,950,1877,4,2,-2,Struggles with job satisfaction after the transition.
951,951,1878,10,10,0,Change made little difference in overall happiness.
952,952,1881,4,2,-2,Struggles with job satisfaction after the transition.
953,953,1883,4,2,-2,Struggles with job satisfaction after the transition.
954,954,1886,7,10,3,Feels more fulfilled and motivated after switching.
955,955,1889,2,3,1,Slight improvement in work-life balance and satisfaction.
956,956,1890,8,6,-2,Struggles with job satisfaction after the transition.
957,957,1893,10,10,0,Change made little difference in overall happiness.
958,958,1894,8,7,-1,Feels unsure about the new role and its demands.
959,959,1896,8,8,0,Change made little difference in overall happiness.
960,960,1898,5,7,2,Feels more fulfilled and motivated after switching.
961,961,1900,8,7,-1,Feels unsure about the new role and its demands.
962,962,1904,5,3,-2,Struggles with job satisfaction after the transition.
963,963,1906,1,3,2,Feels more fulfilled and motivated after switching.
964,964,1908,3,3,0,Change made little difference in overall happiness.
965,965,1910,2,2,0,Change made little difference in overall happiness.
966,966,1911,7,8,1,Slight improvement in work-life balance and satisfaction.
967,967,1912,8,8,0,Change made little difference in overall happiness.
968,968,1914,8,6,-2,Struggles with job satisfaction after the transition.
969,969,1916,7,6,-1,Feels unsure about the new role and its demands.
970,970,1917,10,10,0,Change made little difference in overall happiness.
971,971,1919,5,6,1,Slight improvement in work-life balance and satisfaction.
972,972,1922,1,4,3,Feels more fulfilled and motivated after switching.
973,973,1923,4,5,1,Slight improvement in work-life balance and satisfaction.
974,974,1926,9,7,-2,Struggles with job satisfaction after the transition.
975,975,1929,10,8,-2,Struggles with job satisfaction after the transition.
976,976,1931,8,9,1,Slight improvement in work-life balance and satisfaction.
977,977,1932,4,6,2,Feels more fulfilled and motivated after switching.
978,978,1934,2,1,-1,Feels unsure about the new role and its demands.
979,979,1936,5,4,-1,Feels unsure about the new role and its demands.
980,980,1940,9,10,1,Slight improvement in work-life balance and satisfaction.
981,981,1941,2,3,1,Slight improvement in work-life balance and satisfaction.
982,982,1943,8,7,-1,Feels unsure about the new role and its demands.
983,983,1945,5,5,0,Change made little difference in overall happiness.
984,984,1946,2,5,3,Feels more fulfilled and motivated after switching.
985,985,1949,10,10,0,Change made little difference in overall happiness.
986,986,1953,6,6,0,Change made little difference in overall happiness.
987,987,1955,4,2,-2,Struggles with job satisfaction after the transition.
988,988,1956,5,3,-2,Struggles with job satisfaction after the transition.
989,989,1958,8,7,-1,Feels unsure about the new role and its demands.
990,990,1961,9,7,-2,Struggles with job satisfaction after the transition.
991,991,1964,3,6,3,Feels more fulfilled and motivated after switching.
992,992,1965,9,10,1,Slight improvement in work-life balance and satisfaction.
993,993,1969,3,2,-1,Feels unsure about the new role and its demands.
994,994,1970,10,9,-1,Feels unsure about the new role and its demands.
995,995,1972,1,1,0,Change made little difference in overall happiness.
996,996,1974,10,10,0,Change made little difference in overall happiness.
997,997,1976,1,2,1,Slight improvement in work-life balance and satisfaction.
998,998,1978,4,5,1,Slight improvement in work-life balance and satisfaction.
999,999,1980,9,8,-1,Feels unsure about the new role and its demands.
1000,1000,1983,1,1,0,Change made little difference in overall happiness.
1001,1001,1984,4,4,0,Change made little difference in overall happiness.
1002,1002,1986,9,10,1,Slight improvement in work-life balance and satisfaction.
1003,1003,1989,5,3,-2,Struggles with job satisfaction after the transition.
1004,1004,1991,10,10,0,Change made little difference in overall happiness.
1005,1005,1993,9,7,-2,Struggles with job satisfaction after the transition.
1006,1006,1996,4,5,1,Slight improvement in work-life balance and satisfaction.
1007,1007,1999,10,9,-1,Feels unsure about the new role and its demands.
1008,1008,2000,6,5,-1,Feels unsure about the new role and its demands.
1009,1009,2004,1,1,0,Change made little difference in overall happiness.
1010,1010,2005,5,5,0,Change made little difference in overall happiness.
1011,1011,2006,1,4,3,Feels more fulfilled and motivated after switching.
1012,1012,2010,3,4,1,Slight improvement in work-life balance and satisfaction.
1013,1013,2013,9,8,-1,Feels unsure about the new role and its demands.
1014,1014,2014,1,1,0,Change made little difference in overall happiness.
1015,1015,2017,6,7,1,Slight improvement in work-life balance and satisfaction.
1016,1016,2020,1,1,0,Change made little difference in overall happiness.
1017,1017,2023,7,6,-1,Feels unsure about the new role and its demands.
1018,1018,2027,4,5,1,Slight improvement in work-life balance and satisfaction.
1019,1019,2028,2,5,3,Feels more fulfilled and motivated after switching.
1020,1020,2032,10,10,0,Change made little difference in overall happiness.
1021,1021,2034,2,3,1,Slight improvement in work-life balance and satisfaction.
1022,1022,2038,8,9,1,Slight improvement in work-life balance and satisfaction.
1023,1023,2039,1,4,3,Feels more fulfilled and motivated after switching.
1024,1024,2040,6,6,0,Change made little difference in overall happiness.
1025,1025,2042,3,2,-1,Feels unsure about the new role and its demands.
1026,1026,2046,7,10,3,Feels more fulfilled and motivated after switching.
1027,1027,2047,10,9,-1,Feels unsure about the new role and its demands.
1028,1028,2048,9,9,0,Change made little difference in overall happiness.
1029,1029,2050,3,4,1,Slight improvement in work-life balance and satisfaction.
1030,1030,2051,3,4,1,Slight improvement in work-life balance and satisfaction.
1031,1031,2054,6,4,-2,Struggles with job satisfaction after the transition.
1032,1032,2055,2,1,-1,Feels unsure about the new role and its demands.
1033,1033,2057,6,7,1,Slight improvement in work-life balance and satisfaction.
1034,1034,2059,6,7,1,Slight improvement in work-life balance and satisfaction.
1035,1035,2062,1,4,3,Feels more fulfilled and motivated after switching.
1036,1036,2063,9,8,-1,Feels unsure about the new role and its demands.
1037,1037,2066,5,7,2,Feels more fulfilled and motivated after switching.
1038,1038,2067,4,7,3,Feels more fulfilled and motivated after switching.
1039,1039,2069,5,7,2,Feels more fulfilled and motivated after switching.
1040,1040,2072,6,9,3,Feels more fulfilled and motivated after switching.
1041,1041,2074,10,10,0,Change made little difference in overall happiness.
1042,1042,2076,3,5,2,Feels more fulfilled and motivated after switching.
1043,1043,2077,5,6,1,Slight improvement in work-life balance and satisfaction.
1044,1044,2080,4,3,-1,Feels unsure about the new role and its demands.
1045,1045,2082,5,6,1,Slight improvement in work-life balance and satisfaction.
1046,1046,2083,10,10,0,Change made little difference in overall happiness.
1047,1047,2084,8,10,2,Feels more fulfilled and motivated after switching.
1048,1048,2085,9,10,1,Slight improvement in work-life balance and satisfaction.
1049,1049,2088,1,3,2,Feels more fulfilled and motivated after switching.
1050,1050,2090,4,4,0,Change made little difference in overall happiness.
1051,1051,2091,10,10,0,Change made little difference in overall happiness.
1052,1052,2093,2,4,2,Feels more fulfilled and motivated after switching.
1053,1053,2095,2,5,3,Feels more fulfilled and motivated after switching.
1054,1054,2097,10,10,0,Change made little difference in overall happiness.
1055,1055,2099,9,10,1,Slight improvement in work-life balance and satisfaction.
1056,1056,2101,2,1,-1,Feels unsure about the new role and its demands.
1057,1057,2103,7,6,-1,Feels unsure about the new role and its demands.
1058,1058,2104,10,9,-1,Feels unsure about the new role and its demands.
1059,1059,2107,4,3,-1,Feels unsure about the new role and its demands.
1060,1060,2109,1,4,3,Feels more fulfilled and motivated after switching.
1061,1061,2111,10,10,0,Change made little difference in overall happiness.
1062,1062,2112,5,6,1,Slight improvement in work-life balance and satisfaction.
1063,1063,2117,3,3,0,Change made little difference in overall happiness.
1064,1064,2118,1,1,0,Change made little difference in overall happiness.
1065,1065,2123,8,10,2,Feels more fulfilled and motivated after switching.
1066,1066,2124,6,7,1,Slight improvement in work-life balance and satisfaction.
1067,1067,2125,4,6,2,Feels more fulfilled and motivated after switching.
1068,1068,2128,2,3,1,Slight improvement in work-life balance and satisfaction.
1069,1069,2130,4,7,3,Feels more fulfilled and motivated after switching.
1070,1070,2132,2,4,2,Feels more fulfilled and motivated after switching.
1071,1071,2134,7,5,-2,Struggles with job satisfaction after the transition.
1072,1072,2136,2,1,-1,Feels unsure about the new role and its demands.
1073,1073,2138,9,7,-2,Struggles with job satisfaction after the transition.
1074,1074,2139,5,8,3,Feels more fulfilled and motivated after switching.
1075,1075,2140,10,10,0,Change made little difference in overall happiness.
1076,1076,2141,4,6,2,Feels more fulfilled and motivated after switching.
1077,1077,2142,8,10,2,Feels more fulfilled and motivated after switching.
1078,1078,2143,10,10,0,Change made little difference in overall happiness.
1079,1079,2147,8,7,-1,Feels unsure about the new role and its demands.
1080,1080,2148,3,5,2,Feels more fulfilled and motivated after switching.
1081,1081,2150,10,9,-1,Feels unsure about the new role and its demands.
1082,1082,2152,7,8,1,Slight improvement in work-life balance and satisfaction.
1083,1083,2154,6,8,2,Feels more fulfilled and motivated after switching.
1084,1084,2155,2,1,-1,Feels unsure about the new role and its demands.
1085,1085,2156,3,4,1,Slight improvement in work-life balance and satisfaction.
1086,1086,2158,1,3,2,Feels more fulfilled and motivated after switching.
1087,1087,2159,7,8,1,Slight improvement in work-life balance and satisfaction.
1088,1088,2161,10,10,0,Change made little difference in overall happiness.
1089,1089,2165,5,8,3,Feels more fulfilled and motivated after switching.
1090,1090,2166,7,9,2,Feels more fulfilled and motivated after switching.
1091,1091,2169,10,10,0,Change made little difference in overall happiness.
1092,1092,2170,1,1,0,Change made little difference in overall happiness.
1093,1093,2174,1,2,1,Slight improvement in work-life balance and satisfaction.
1094,1094,2175,5,8,3,Feels more fulfilled and motivated after switching.
1095,1095,2179,2,1,-1,Feels unsure about the new role and its demands.
1096,1096,2181,2,3,1,Slight improvement in work-life balance and satisfaction.
1097,1097,2182,9,8,-1,Feels unsure about the new role and its demands.
1098,1098,2183,2,3,1,Slight improvement in work-life balance and satisfaction.
1099,1099,2186,3,6,3,Feels more fulfilled and motivated after switching.
1100,1100,2188,4,2,-2,Struggles with job satisfaction after the transition.
1101,1101,2189,9,10,1,Slight improvement in work-life balance and satisfaction.
1102,1102,2191,10,10,0,Change made little difference in overall happiness.
1103,1103,2193,9,9,0,Change made little difference in overall happiness.
1104,1104,2195,3,4,1,Slight improvement in work-life balance and satisfaction.
1105,1105,2197,9,10,1,Slight improvement in work-life balance and satisfaction.
1106,1106,2199,6,4,-2,Struggles with job satisfaction after the transition.
1107,1107,2201,8,10,2,Feels more fulfilled and motivated after switching.
1108,1108,2204,5,7,2,Feels more fulfilled and motivated after switching.
1109,1109,2205,9,10,1,Slight improvement in work-life balance and satisfaction.
1110,1110,2207,4,5,1,Slight improvement in work-life balance and satisfaction.
1111,1111,2209,7,8,1,Slight improvement in work-life balance and satisfaction.
1112,1112,2211,1,1,0,Change made little difference in overall happiness.
1113,1113,2213,9,10,1,Slight improvement in work-life balance and satisfaction.
1114,1114,2217,3,3,0,Change made little difference in overall happiness.
1115,1115,2218,9,8,-1,Feels unsure about the new role and its demands.
1116,1116,2219,7,8,1,Slight improvement in work-life balance and satisfaction.
1117,1117,2220,3,4,1,Slight improvement in work-life balance and satisfaction.
1118,1118,2221,4,7,3,Feels more fulfilled and motivated after switching.
1119,1119,2222,4,5,1,Slight improvement in work-life balance and satisfaction.
1120,1120,2224,2,5,3,Feels more fulfilled and motivated after switching.
1121,1121,2227,7,10,3,Feels more fulfilled and motivated after switching.
1122,1122,2228,2,4,2,Feels more fulfilled and motivated after switching.
1123,1123,2229,6,8,2,Feels more fulfilled and motivated after switching.
1124,1124,2232,4,4,0,Change made little difference in overall happiness.
1125,1125,2234,9,9,0,Change made little difference in overall happiness.
1126,1126,2237,2,1,-1,Feels unsure about the new role and its demands.
1127,1127,2239,8,6,-2,Struggles with job satisfaction after the transition.
1128,1128,2241,10,10,0,Change made little difference in overall happiness.
1129,1129,2246,3,1,-2,Struggles with job satisfaction after the transition.
1130,1130,2247,1,1,0,Change made little difference in overall happiness.
1131,1131,2249,4,3,-1,Feels unsure about the new role and its demands.
1132,1132,2250,8,10,2,Feels more fulfilled and motivated after switching.
1133,1133,2253,3,5,2,Feels more fulfilled and motivated after switching.
1134,1134,2254,4,7,3,Feels more fulfilled and motivated after switching.
1135,1135,2256,10,10,0,Change made little difference in overall happiness.
1136,1136,2258,6,8,2,Feels more fulfilled and motivated after switching.
1137,1137,2259,2,5,3,Feels more fulfilled and motivated after switching.
1138,1138,2260,4,6,2,Feels more fulfilled and motivated after switching.
1139,1139,2262,7,10,3,Feels more fulfilled and motivated after switching.
1140,1140,2264,10,10,0,Change made little difference in overall happiness.
1141,1141,2265,6,7,1,Slight improvement in work-life balance and satisfaction.
1142,1142,2266,3,1,-2,Struggles with job satisfaction after the transition.
1143,1143,2268,3,3,0,Change made little difference in overall happiness.
1144,1144,2270,9,10,1,Slight improvement in work-life balance and satisfaction.
1145,1145,2271,3,3,0,Change made little difference in overall happiness.
1146,1146,2272,10,9,-1,Feels unsure about the new role and its demands.
1147,1147,2274,6,7,1,Slight improvement in work-life balance and satisfaction.
1148,1148,2278,8,7,-1,Feels unsure about the new role and its demands.
1149,1149,2281,10,8,-2,Struggles with job satisfaction after the transition.
1150,1150,2283,9,8,-1,Feels unsure about the new role and its demands.
1151,1151,2287,3,4,1,Slight improvement in work-life balance and satisfaction.
1152,1152,2288,2,5,3,Feels more fulfilled and motivated after switching.
1153,1153,2291,8,7,-1,Feels unsure about the new role and its demands.
1154,1154,2292,1,2,1,Slight improvement in work-life balance and satisfaction.
1155,1155,2295,5,4,-1,Feels unsure about the new role and its demands.
1156,1156,2297,9,10,1,Slight improvement in work-life balance and satisfaction.
1157,1157,2298,2,1,-1,Feels unsure about the new role and its demands.
1158,1158,2299,4,6,2,Feels more fulfilled and motivated after switching.
1159,1159,2302,4,7,3,Feels more fulfilled and motivated after switching.
1160,1160,2303,5,7,2,Feels more fulfilled and motivated after switching.
1161,1161,2306,8,6,-2,Struggles with job satisfaction after the transition.
1162,1162,2308,8,10,2,Feels more fulfilled and motivated after switching.
1163,1163,2309,8,10,2,Feels more fulfilled and motivated after switching.
1164,1164,2311,7,9,2,Feels more fulfilled and motivated after switching.
1165,1165,2313,5,4,-1,Feels unsure about the new role and its demands.
1166,1166,2314,2,5,3,Feels more fulfilled and motivated after switching.
1167,1167,2317,7,6,-1,Feels unsure about the new role and its demands.
1168,1168,2318,3,2,-1,Feels unsure about the new role and its demands.
1169,1169,2321,8,10,2,Feels more fulfilled and motivated after switching.
1170,1170,2322,4,3,-1,Feels unsure about the new role and its demands.
1171,1171,2324,7,5,-2,Struggles with job satisfaction after the transition.
1172,1172,2326,7,9,2,Feels more fulfilled and motivated after switching.
1173,1173,2328,10,10,0,Change made little difference in overall happiness.
1174,1174,2330,10,9,-1,Feels unsure about the new role and its demands.
1175,1175,2332,3,4,1,Slight improvement in work-life balance and satisfaction.
1176,1176,2334,4,5,1,Slight improvement in work-life balance and satisfaction.
1177,1177,2335,9,10,1,Slight improvement in work-life balance and satisfaction.
1178,1178,2337,10,8,-2,Struggles with job satisfaction after the transition.
1179,1179,2338,4,6,2,Feels more fulfilled and motivated after switching.
1180,1180,2339,10,10,0,Change made little difference in overall happiness.
1181,1181,2341,9,8,-1,Feels unsure about the new role and its demands.
1182,1182,2344,3,5,2,Feels more fulfilled and motivated after switching.
1183,1183,2345,3,6,3,Feels more fulfilled and motivated after switching.
1184,1184,2348,8,6,-2,Struggles with job satisfaction after the transition.
1185,1185,2349,4,6,2,Feels more fulfilled and motivated after switching.
1186,1186,2352,8,10,2,Feels more fulfilled and motivated after switching.
1187,1187,2354,2,4,2,Feels more fulfilled and motivated after switching.
1188,1188,2357,1,2,1,Slight improvement in work-life balance and satisfaction.
1189,1189,2359,1,4,3,Feels more fulfilled and motivated after switching.
1190,1190,2360,10,10,0,Change made little difference in overall happiness.
1191,1191,2361,8,6,-2,Struggles with job satisfaction after the transition.
1192,1192,2362,8,6,-2,Struggles with job satisfaction after the transition.
1193,1193,2365,1,4,3,Feels more fulfilled and motivated after switching.
1194,1194,2366,1,3,2,Feels more fulfilled and motivated after switching.
1195,1195,2367,6,8,2,Feels more fulfilled and motivated after switching.
1196,1196,2371,6,7,1,Slight improvement in work-life balance and satisfaction.
1197,1197,2372,1,1,0,Change made little difference in overall happiness.
1198,1198,2373,9,10,1,Slight improvement in work-life balance and satisfaction.
1199,1199,2376,4,2,-2,Struggles with job satisfaction after the transition.
1200,1200,2378,4,3,-1,Feels unsure about the new role and its demands.
1201,1201,2380,4,4,0,Change made little difference in overall happiness.
1202,1202,2381,4,2,-2,Struggles with job satisfaction after the transition.
1203,1203,2385,8,10,2,Feels more fulfilled and motivated after switching.
1204,1204,2386,9,10,1,Slight improvement in work-life balance and satisfaction.
1205,1205,2388,10,10,0,Change made little difference in overall happiness.
1206,1206,2389,4,2,-2,Struggles with job satisfaction after the transition.
1207,1207,2392,4,5,1,Slight improvement in work-life balance and satisfaction.
1208,1208,2394,8,9,1,Slight improvement in work-life balance and satisfaction.
1209,1209,2399,5,8,3,Feels more fulfilled and motivated after switching.
1210,1210,2402,4,7,3,Feels more fulfilled and motivated after switching.
1211,1211,2403,5,4,-1,Feels unsure about the new role and its demands.
1212,1212,2406,8,9,1,Slight improvement in work-life balance and satisfaction.
1213,1213,2407,9,9,0,Change made little difference in overall happiness.
1214,1214,2410,10,10,0,Change made little difference in overall happiness.
1215,1215,2411,1,1,0,Change made little difference in overall happiness.
1216,1216,2413,5,6,1,Slight improvement in work-life balance and satisfaction.
1217,1217,2414,6,9,3,Feels more fulfilled and motivated after switching.
1218,1218,2415,10,10,0,Change made little difference in overall happiness.
1219,1219,2419,3,6,3,Feels more fulfilled and motivated after switching.
1220,1220,2421,7,7,0,Change made little difference in overall happiness.
1221,1221,2425,6,8,2,Feels more fulfilled and motivated after switching.
1222,1222,2427,10,8,-2,Struggles with job satisfaction after the transition.
1223,1223,2429,8,9,1,Slight improvement in work-life balance and satisfaction.
1224,1224,2431,9,10,1,Slight improvement in work-life balance and satisfaction.
1225,1225,2434,3,4,1,Slight improvement in work-life balance and satisfaction.
1226,1226,2436,8,7,-1,Feels unsure about the new role and its demands.
1227,1227,2439,9,7,-2,Struggles with job satisfaction after the transition.
1228,1228,2440,10,10,0,Change made little difference in overall happiness.
1229,1229,2443,10,10,0,Change made little difference in overall happiness.
1230,1230,2445,1,4,3,Feels more fulfilled and motivated after switching.
1231,1231,2446,1,3,2,Feels more fulfilled and motivated after switching.
1232,1232,2448,4,3,-1,Feels unsure about the new role and its demands.
1233,1233,2449,3,4,1,Slight improvement in work-life balance and satisfaction.
1234,1234,2452,6,8,2,Feels more fulfilled and motivated after switching.
1235,1235,2455,9,10,1,Slight improvement in work-life balance and satisfaction.
1236,1236,2456,6,7,1,Slight improvement in work-life balance and satisfaction.
1237,1237,2459,7,8,1,Slight improvement in work-life balance and satisfaction.
1238,1238,2461,6,6,0,Change made little difference in overall happiness.
1239,1239,2462,5,6,1,Slight improvement in work-life balance and satisfaction.
1240,1240,2463,10,10,0,Change made little difference in overall happiness.
1241,1241,2464,7,10,3,Feels more fulfilled and motivated after switching.
1242,1242,2466,7,10,3,Feels more fulfilled and motivated after switching.
1243,1243,2468,2,5,3,Feels more fulfilled and motivated after switching.
1244,1244,2469,7,8,1,Slight improvement in work-life balance and satisfaction.
1245,1245,2471,4,5,1,Slight improvement in work-life balance and satisfaction.
1246,1246,2473,5,8,3,Feels more fulfilled and motivated after switching.
1247,1247,2474,9,10,1,Slight improvement in work-life balance and satisfaction.
1248,1248,2477,2,4,2,Feels more fulfilled and motivated after switching.
1249,1249,2479,3,2,-1,Feels unsure about the new role and its demands.
1250,1250,2480,8,7,-1,Feels unsure about the new role and its demands.
1251,1251,2482,10,10,0,Change made little difference in overall happiness.
1252,1252,2484,2,5,3,Feels more fulfilled and motivated after switching.
1253,1253,2486,4,6,2,Feels more fulfilled and motivated after switching.
1254,1254,2489,4,6,2,Feels more fulfilled and motivated after switching.
1255,1255,2491,5,4,-1,Feels unsure about the new role and its demands.
1256,1256,2492,4,6,2,Feels more fulfilled and motivated after switching.
1257,1257,2494,3,1,-2,Struggles with job satisfaction after the transition.
1258,1258,2497,4,2,-2,Struggles with job satisfaction after the transition.
1259,1259,2498,1,1,0,Change made little difference in overall happiness.
1260,1260,2501,8,10,2,Feels more fulfilled and motivated after switching.
1261,1261,2503,1,1,0,Change made little difference in overall happiness.
1262,1262,2507,5,8,3,Feels more fulfilled and motivated after switching.
1263,1263,2508,8,8,0,Change made little difference in overall happiness.
1264,1264,2511,3,4,1,Slight improvement in work-life balance and satisfaction.
1265,1265,2513,4,4,0,Change made little difference in overall happiness.
1266,1266,2516,6,9,3,Feels more fulfilled and motivated after switching.
1267,1267,2517,7,9,2,Feels more fulfilled and motivated after switching.
1268,1268,2518,9,7,-2,Struggles with job satisfaction after the transition.
1269,1269,2520,2,2,0,Change made little difference in overall happiness.
1270,1270,2522,4,7,3,Feels more fulfilled and motivated after switching.
1271,1271,2525,5,8,3,Feels more fulfilled and motivated after switching.
1272,1272,2526,8,7,-1,Feels unsure about the new role and its demands.
1273,1273,2527,6,4,-2,Struggles with job satisfaction after the transition.
1274,1274,2530,5,3,-2,Struggles with job satisfaction after the transition.
1275,1275,2532,8,9,1,Slight improvement in work-life balance and satisfaction.
1276,1276,2533,8,10,2,Feels more fulfilled and motivated after switching.
1277,1277,2534,4,4,0,Change made little difference in overall happiness.
1278,1278,2536,8,6,-2,Struggles with job satisfaction after the transition.
1279,1279,2538,5,7,2,Feels more fulfilled and motivated after switching.
1280,1280,2539,2,1,-1,Feels unsure about the new role and its demands.
1281,1281,2541,4,4,0,Change made little difference in overall happiness.
1282,1282,2544,2,2,0,Change made little difference in overall happiness.
1283,1283,2546,4,2,-2,Struggles with job satisfaction after the transition.
1284,1284,2547,6,5,-1,Feels unsure about the new role and its demands.
1285,1285,2549,5,7,2,Feels more fulfilled and motivated after switching.
1286,1286,2550,9,10,1,Slight improvement in work-life balance and satisfaction.
1287,1287,2554,3,5,2,Feels more fulfilled and motivated after switching.
1288,1288,2555,10,10,0,Change made little difference in overall happiness.
1289,1289,2557,8,9,1,Slight improvement in work-life balance and satisfaction.
1290,1290,2558,6,9,3,Feels more fulfilled and motivated after switching.
1291,1291,2559,10,10,0,Change made little difference in overall happiness.
1292,1292,2560,10,10,0,Change made little difference in overall happiness.
1293,1293,2562,7,7,0,Change made little difference in overall happiness.
1294,1294,2563,8,7,-1,Feels unsure about the new role and its demands.
1295,1295,2565,6,9,3,Feels more fulfilled and motivated after switching.
1296,1296,2566,3,4,1,Slight improvement in work-life balance and satisfaction.
1297,1297,2568,4,3,-1,Feels unsure about the new role and its demands.
1298,1298,2569,6,9,3,Feels more fulfilled and motivated after switching.
1299,1299,2573,1,2,1,Slight improvement in work-life balance and satisfaction.
1300,1300,2576,8,8,0,Change made little difference in overall happiness.
1301,1301,2579,1,1,0,Change made little difference in overall happiness.
1302,1302,2580,1,1,0,Change made little difference in overall happiness.
1303,1303,2583,5,7,2,Feels more fulfilled and motivated after switching.
1304,1304,2584,1,3,2,Feels more fulfilled and motivated after switching.
1305,1305,2585,7,9,2,Feels more fulfilled and motivated after switching.
1306,1306,2586,9,10,1,Slight improvement in work-life balance and satisfaction.
1307,1307,2589,9,10,1,Slight improvement in work-life balance and satisfaction.
1308,1308,2591,8,10,2,Feels more fulfilled and motivated after switching.
1309,1309,2592,1,3,2,Feels more fulfilled and motivated after switching.
1310,1310,2594,4,2,-2,Struggles with job satisfaction after the transition.
1311,1311,2595,8,10,2,Feels more fulfilled and motivated after switching.
1312,1312,2597,2,2,0,Change made little difference in overall happiness.
1313,1313,2599,4,2,-2,Struggles with job satisfaction after the transition.
1314,1314,2601,5,3,-2,Struggles with job satisfaction after the transition.
1315,1315,2602,7,7,0,Change made little difference in overall happiness.
1316,1316,2604,4,3,-1,Feels unsure about the new role and its demands.
1317,1317,2607,7,10,3,Feels more fulfilled and motivated after switching.
1318,1318,2610,6,8,2,Feels more fulfilled and motivated after switching.
1319,1319,2611,4,4,0,Change made little difference in overall happiness.
1320,1320,2614,2,1,-1,Feels unsure about the new role and its demands.
1321,1321,2617,9,9,0,Change made little difference in overall happiness.
1322,1322,2618,7,5,-2,Struggles with job satisfaction after the transition.
1323,1323,2619,8,6,-2,Struggles with job satisfaction after the transition.
1324,1324,2620,2,1,-1,Feels unsure about the new role and its demands.
1325,1325,2622,4,3,-1,Feels unsure about the new role and its demands.
1326,1326,2623,1,1,0,Change made little difference in overall happiness.
1327,1327,2626,2,5,3,Feels more fulfilled and motivated after switching.
1328,1328,2627,2,4,2,Feels more fulfilled and motivated after switching.
1329,1329,2629,2,4,2,Feels more fulfilled and motivated after switching.
1330,1330,2630,8,9,1,Slight improvement in work-life balance and satisfaction.
1331,1331,2632,8,9,1,Slight improvement in work-life balance and satisfaction.
1332,1332,2634,2,5,3,Feels more fulfilled and motivated after switching.
1333,1333,2635,7,5,-2,Struggles with job satisfaction after the transition.
1334,1334,2636,8,10,2,Feels more fulfilled and motivated after switching.
1335,1335,2639,9,10,1,Slight improvement in work-life balance and satisfaction.
1336,1336,2641,8,9,1,Slight improvement in work-life balance and satisfaction.
1337,1337,2643,10,8,-2,Struggles with job satisfaction after the transition.
1338,1338,2646,9,10,1,Slight improvement in work-life balance and satisfaction.
1339,1339,2648,7,10,3,Feels more fulfilled and motivated after switching.
1340,1340,2649,3,2,-1,Feels unsure about the new role and its demands.
1341,1341,2650,6,5,-1,Feels unsure about the new role and its demands.
1342,1342,2651,3,4,1,Slight improvement in work-life balance and satisfaction.
1343,1343,2653,4,3,-1,Feels unsure about the new role and its demands.
1344,1344,2654,10,10,0,Change made little difference in overall happiness.
1345,1345,2655,1,4,3,Feels more fulfilled and motivated after switching.
1346,1346,2658,4,7,3,Feels more fulfilled and motivated after switching.
1347,1347,2659,8,8,0,Change made little difference in overall happiness.
1348,1348,2661,7,9,2,Feels more fulfilled and motivated after switching.
1349,1349,2665,7,10,3,Feels more fulfilled and motivated after switching.
1350,1350,2666,4,5,1,Slight improvement in work-life balance and satisfaction.
1351,1351,2669,9,9,0,Change made little difference in overall happiness.
1352,1352,2671,5,3,-2,Struggles with job satisfaction after the transition.
1353,1353,2673,9,10,1,Slight improvement in work-life balance and satisfaction.
1354,1354,2676,2,1,-1,Feels unsure about the new role and its demands.
1355,1355,2679,9,7,-2,Struggles with job satisfaction after the transition.
1356,1356,2680,3,5,2,Feels more fulfilled and motivated after switching.
1357,1357,2681,5,4,-1,Feels unsure about the new role and its demands.
1358,1358,2684,2,1,-1,Feels unsure about the new role and its demands.
1359,1359,2685,1,1,0,Change made little difference in overall happiness.
1360,1360,2686,7,5,-2,Struggles with job satisfaction after the transition.
1361,1361,2688,1,1,0,Change made little difference in overall happiness.
1362,1362,2689,2,2,0,Change made little difference in overall happiness.
1363,1363,2692,4,4,0,Change made little difference in overall happiness.
1364,1364,2694,3,6,3,Feels more fulfilled and motivated after switching.
1365,1365,2696,4,4,0,Change made little difference in overall happiness.
1366,1366,2697,7,6,-1,Feels unsure about the new role and its demands.
1367,1367,2699,2,1,-1,Feels unsure about the new role and its demands.
1368,1368,2700,9,10,1,Slight improvement in work-life balance and satisfaction.
1369,1369,2704,7,9,2,Feels more fulfilled and motivated after switching.
1370,1370,2707,5,6,1,Slight improvement in work-life balance and satisfaction.
1371,1371,2708,8,7,-1,Feels unsure about the new role and its demands.
1372,1372,2710,2,1,-1,Feels unsure about the new role and its demands.
1373,1373,2712,6,7,1,Slight improvement in work-life balance and satisfaction.
1374,1374,2713,1,4,3,Feels more fulfilled and motivated after switching.
1375,1375,2718,10,10,0,Change made little difference in overall happiness.
1376,1376,2719,7,5,-2,Struggles with job satisfaction after the transition.
1377,1377,2722,3,5,2,Feels more fulfilled and motivated after switching.
1378,1378,2723,6,4,-2,Struggles with job satisfaction after the transition.
1379,1379,2726,5,7,2,Feels more fulfilled and motivated after switching.
1380,1380,2728,5,3,-2,Struggles with job satisfaction after the transition.
1381,1381,2730,9,10,1,Slight improvement in work-life balance and satisfaction.
1382,1382,2732,5,4,-1,Feels unsure about the new role and its demands.
1383,1383,2734,2,2,0,Change made little difference in overall happiness.
1384,1384,2737,8,9,1,Slight improvement in work-life balance and satisfaction.
1385,1385,2739,8,10,2,Feels more fulfilled and motivated after switching.
1386,1386,2741,8,8,0,Change made little difference in overall happiness.
1387,1387,2743,3,2,-1,Feels unsure about the new role and its demands.
1388,1388,2744,1,1,0,Change made little difference in overall happiness.
1389,1389,2745,3,4,1,Slight improvement in work-life balance and satisfaction.
1390,1390,2749,10,8,-2,Struggles with job satisfaction after the transition.
1391,1391,2750,1,1,0,Change made little difference in overall happiness.
1392,1392,2752,3,4,1,Slight improvement in work-life balance and satisfaction.
1393,1393,2755,8,10,2,Feels more fulfilled and motivated after switching.
1394,1394,2757,1,2,1,Slight improvement in work-life balance and satisfaction.
1395,1395,2761,2,2,0,Change made little difference in overall happiness.
1396,1396,2762,5,8,3,Feels more fulfilled and motivated after switching.
1397,1397,2764,5,7,2,Feels more fulfilled and motivated after switching.
1398,1398,2767,3,2,-1,Feels unsure about the new role and its demands.
1399,1399,2768,7,8,1,Slight improvement in work-life balance and satisfaction.
1400,1400,2770,1,1,0,Change made little difference in overall happiness.
1401,1401,2772,9,10,1,Slight improvement in work-life balance and satisfaction.
1402,1402,2773,4,2,-2,Struggles with job satisfaction after the transition.
1403,1403,2776,7,5,-2,Struggles with job satisfaction after the transition.
1404,1404,2777,5,8,3,Feels more fulfilled and motivated after switching.
1405,1405,2780,8,7,-1,Feels unsure about the new role and its demands.
1406,1406,2784,8,10,2,Feels more fulfilled and motivated after switching.
1407,1407,2785,9,7,-2,Struggles with job satisfaction after the transition.
1408,1408,2786,4,7,3,Feels more fulfilled and motivated after switching.
1409,1409,2788,3,1,-2,Struggles with job satisfaction after the transition.
1410,1410,2793,6,4,-2,Struggles with job satisfaction after the transition.
1411,1411,2794,9,9,0,Change made little difference in overall happiness.
1412,1412,2798,6,4,-2,Struggles with job satisfaction after the transition.
1413,1413,2800,3,1,-2,Struggles with job satisfaction after the transition.
1414,1414,2802,2,5,3,Feels more fulfilled and motivated after switching.
1415,1415,2804,7,5,-2,Struggles with job satisfaction after the transition.
1416,1416,2805,10,10,0,Change made little difference in overall happiness.
1417,1417,2807,6,7,1,Slight improvement in work-life balance and satisfaction.
1418,1418,2808,6,8,2,Feels more fulfilled and motivated after switching.
1419,1419,2809,7,9,2,Feels more fulfilled and motivated after switching.
1420,1420,2810,4,2,-2,Struggles with job satisfaction after the transition.
1421,1421,2814,2,5,3,Feels more fulfilled and motivated after switching.
1422,1422,2816,10,10,0,Change made little difference in overall happiness.
1423,1423,2817,2,4,2,Feels more fulfilled and motivated after switching.
1424,1424,2819,5,6,1,Slight improvement in work-life balance and satisfaction.
1425,1425,2820,4,5,1,Slight improvement in work-life balance and satisfaction.
1426,1426,2822,7,7,0,Change made little difference in overall happiness.
1427,1427,2823,8,7,-1,Feels unsure about the new role and its demands.
1428,1428,2825,1,3,2,Feels more fulfilled and motivated after switching.
1429,1429,2828,7,8,1,Slight improvement in work-life balance and satisfaction.
1430,1430,2831,1,1,0,Change made little difference in overall happiness.
1431,1431,2835,8,8,0,Change made little difference in overall happiness.
1432,1432,2837,7,7,0,Change made little difference in overall happiness.
1433,1433,2838,4,7,3,Feels more fulfilled and motivated after switching.
1434,1434,2840,2,5,3,Feels more fulfilled and motivated after switching.
1435,1435,2841,10,8,-2,Struggles with job satisfaction after the transition.
1436,1436,2845,10,8,-2,Struggles with job satisfaction after the transition.
1437,1437,2846,5,5,0,Change made little difference in overall happiness.
1438,1438,2849,6,7,1,Slight improvement in work-life balance and satisfaction.
1439,1439,2850,9,10,1,Slight improvement in work-life balance and satisfaction.
1440,1440,2852,4,5,1,Slight improvement in work-life balance and satisfaction.
1441,1441,2853,5,4,-1,Feels unsure about the new role and its demands.
1442,1442,2855,3,6,3,Feels more fulfilled and motivated after switching.
1443,1443,2856,9,7,-2,Struggles with job satisfaction after the transition.
1444,1444,2857,8,10,2,Feels more fulfilled and motivated after switching.
1445,1445,2858,10,8,-2,Struggles with job satisfaction after the transition.
1446,1446,2860,2,1,-1,Feels unsure about the new role and its demands.
1447,1447,2862,10,9,-1,Feels unsure about the new role and its demands.
1448,1448,2865,9,10,1,Slight improvement in work-life balance and satisfaction.
1449,1449,2868,5,5,0,Change made little difference in overall happiness.
1450,1450,2871,4,5,1,Slight improvement in work-life balance and satisfaction.
1451,1451,2872,8,6,-2,Struggles with job satisfaction after the transition.
1452,1452,2875,1,1,0,Change made little difference in overall happiness.
1453,1453,2877,10,10,0,Change made little difference in overall happiness.
1454,1454,2881,2,4,2,Feels more fulfilled and motivated after switching.
1455,1455,2882,3,1,-2,Struggles with job satisfaction after the transition.
1456,1456,2883,2,4,2,Feels more fulfilled and motivated after switching.
1457,1457,2885,8,10,2,Feels more fulfilled and motivated after switching.
1458,1458,2887,10,10,0,Change made little difference in overall happiness.
1459,1459,2888,4,5,1,Slight improvement in work-life balance and satisfaction.
1460,1460,2890,10,10,0,Change made little difference in overall happiness.
1461,1461,2893,9,10,1,Slight improvement in work-life balance and satisfaction.
1462,1462,2894,10,8,-2,Struggles with job satisfaction after the transition.
1463,1463,2895,5,3,-2,Struggles with job satisfaction after the transition.
1464,1464,2897,7,7,0,Change made little difference in overall happiness.
1465,1465,2898,4,5,1,Slight improvement in work-life balance and satisfaction.
1466,1466,2899,2,2,0,Change made little difference in overall happiness.
1467,1467,2901,7,10,3,Feels more fulfilled and motivated after switching.
1468,1468,2903,9,10,1,Slight improvement in work-life balance and satisfaction.
1469,1469,2906,2,5,3,Feels more fulfilled and motivated after switching.
1470,1470,2909,7,8,1,Slight improvement in work-life balance and satisfaction.
1471,1471,2911,7,8,1,Slight improvement in work-life balance and satisfaction.
1472,1472,2913,5,8,3,Feels more fulfilled and motivated after switching.
1473,1473,2916,2,3,1,Slight improvement in work-life balance and satisfaction.
1474,1474,2920,7,9,2,Feels more fulfilled and motivated after switching.
1475,1475,2921,9,10,1,Slight improvement in work-life balance and satisfaction.
1476,1476,2925,1,1,0,Change made little difference in overall happiness.
1477,1477,2927,2,2,0,Change made little difference in overall happiness.
1478,1478,2930,9,9,0,Change made little difference in overall happiness.
1479,1479,2932,7,5,-2,Struggles with job satisfaction after the transition.
1480,1480,2935,7,9,2,Feels more fulfilled and motivated after switching.
1481,1481,2936,8,10,2,Feels more fulfilled and motivated after switching.
1482,1482,2938,5,6,1,Slight improvement in work-life balance and satisfaction.
1483,1483,2941,7,6,-1,Feels unsure about the new role and its demands.
1484,1484,2945,2,1,-1,Feels unsure about the new role and its demands.
1485,1485,2946,2,1,-1,Feels unsure about the new role and its demands.
1486,1486,2947,5,8,3,Feels more fulfilled and motivated after switching.
1487,1487,2949,8,10,2,Feels more fulfilled and motivated after switching.
1488,1488,2952,9,10,1,Slight improvement in work-life balance and satisfaction.
1489,1489,2954,5,3,-2,Struggles with job satisfaction after the transition.
1490,1490,2957,8,8,0,Change made little difference in overall happiness.
1491,1491,2958,2,2,0,Change made little difference in overall happiness.
1492,1492,2960,2,5,3,Feels more fulfilled and motivated after switching.
1493,1493,2961,1,1,0,Change made little difference in overall happiness.
1494,1494,2963,2,5,3,Feels more fulfilled and motivated after switching.
1495,1495,2965,2,1,-1,Feels unsure about the new role and its demands.
1496,1496,2966,1,4,3,Feels more fulfilled and motivated after switching.
1497,1497,2969,4,7,3,Feels more fulfilled and motivated after switching.
1498,1498,2971,4,7,3,Feels more fulfilled and motivated after switching.
1499,1499,2974,6,4,-2,Struggles with job satisfaction after the transition.
1500,1500,2975,4,7,3,Feels more fulfilled and motivated after switching.
